kommun,year,befolkning_sverigefodda_antal,befolkning_europafodda_antal,befolkning_utaneuropafodda_antal,befolkning,befolkning_sverigefodda_procent,befolkning_europafodda_procent,befolkning_utaneuropafodda_procent
0114,2010,30123,4851,4315,39289,76.67,12.35,10.98
0114,2011,30429,5032,4733,40194,75.71,12.52,11.78
0114,2012,30637,5087,4999,40723,75.23,12.49,12.28
0114,2013,30835,5208,5406,41449,74.39,12.56,13.04
0114,2014,30940,5269,5607,41816,73.99,12.60,13.41
0114,2015,31147,5446,6068,42661,73.01,12.77,14.22
0114,2016,31448,5691,6752,43891,71.65,12.97,15.38
0114,2017,31596,5738,7271,44605,70.84,12.86,16.30
0114,2018,31747,5876,7920,45543,69.71,12.90,17.39
0114,2019,32098,6010,8678,46786,68.61,12.85,18.55
0114,2020,32057,6036,9091,47184,67.94,12.79,19.27
0114,2021,32038,6076,9706,47820,67.00,12.71,20.30
0114,2022,32394,6360,10508,49262,65.76,12.91,21.33
0114,2023,32466,6503,11141,50110,64.79,12.98,22.23
0115,2010,26694,1993,1427,30114,88.64,6.62,4.74
0115,2011,27115,2075,1525,30715,88.28,6.76,4.97
0115,2012,27411,2206,1598,31215,87.81,7.07,5.12
0115,2013,27725,2228,1663,31616,87.69,7.05,5.26
0115,2014,27972,2296,1701,31969,87.50,7.18,5.32
0115,2015,28233,2396,1751,32380,87.19,7.40,5.41
0115,2016,28384,2508,1893,32785,86.58,7.65,5.77
0115,2017,28508,2601,2066,33175,85.93,7.84,6.23
0115,2018,28596,2678,2158,33432,85.53,8.01,6.45
0115,2019,28886,2755,2449,34090,84.73,8.08,7.18
0115,2020,28909,2757,2453,34119,84.73,8.08,7.19
0115,2021,28870,2852,2524,34246,84.30,8.33,7.37
0115,2022,29130,3001,2720,34851,83.58,8.61,7.80
0115,2023,29256,3078,2742,35076,83.41,8.78,7.82
0117,2010,34715,2982,1824,39521,87.84,7.55,4.62
0117,2011,34787,3093,1912,39792,87.42,7.77,4.80
0117,2012,34997,3254,2018,40269,86.91,8.08,5.01
0117,2013,35101,3335,2059,40495,86.68,8.24,5.08
0117,2014,35490,3509,2181,41180,86.18,8.52,5.30
0117,2015,36013,3763,2354,42130,85.48,8.93,5.59
0117,2016,36617,4062,2614,43293,84.58,9.38,6.04
0117,2017,37013,4204,2913,44130,83.87,9.53,6.60
0117,2018,37455,4244,3132,44831,83.55,9.47,6.99
0117,2019,37932,4374,3268,45574,83.23,9.60,7.17
0117,2020,38720,4528,3396,46644,83.01,9.71,7.28
0117,2021,39785,4831,3618,48234,82.48,10.02,7.50
0117,2022,40349,4997,3792,49138,82.11,10.17,7.72
0117,2023,40510,4986,3786,49282,82.20,10.12,7.68
0120,2010,34093,2954,1254,38301,89.01,7.71,3.27
0120,2011,34557,2993,1344,38894,88.85,7.70,3.46
0120,2012,34953,3022,1412,39387,88.74,7.67,3.58
0120,2013,35250,3091,1443,39784,88.60,7.77,3.63
0120,2014,35798,3215,1528,40541,88.30,7.93,3.77
0120,2015,36235,3223,1649,41107,88.15,7.84,4.01
0120,2016,36865,3278,1857,42000,87.77,7.80,4.42
0120,2017,37761,3436,2247,43444,86.92,7.91,5.17
0120,2018,38324,3564,2509,44397,86.32,8.03,5.65
0120,2019,38742,3641,2617,45000,86.09,8.09,5.82
0120,2020,39172,3739,2655,45566,85.97,8.21,5.83
0120,2021,39732,3844,2656,46232,85.94,8.31,5.74
0120,2022,39899,3866,2692,46457,85.88,8.32,5.79
0120,2023,39986,3925,2726,46637,85.74,8.42,5.85
0123,2010,50873,6620,8718,66211,76.83,10.00,13.17
0123,2011,51227,6740,9353,67320,76.09,10.01,13.89
0123,2012,51485,6848,9877,68210,75.48,10.04,14.48
0123,2013,51772,6925,10470,69167,74.85,10.01,15.14
0123,2014,52264,7172,11265,70701,73.92,10.14,15.93
0123,2015,52984,7385,12060,72429,73.15,10.20,16.65
0123,2016,53531,7699,13182,74412,71.94,10.35,17.71
0123,2017,54238,7886,14329,76453,70.94,10.31,18.74
0123,2018,54564,8183,15733,78480,69.53,10.43,20.05
0123,2019,54797,8380,16813,79990,68.50,10.48,21.02
0123,2020,54912,8484,17878,81274,67.56,10.44,22.00
0123,2021,55242,8794,19134,83170,66.42,10.57,23.01
0123,2022,55786,9145,20529,85460,65.28,10.70,24.02
0123,2023,55778,9265,21287,86330,64.61,10.73,24.66
0125,2010,22979,1624,807,25410,90.43,6.39,3.18
0125,2011,23218,1689,860,25767,90.11,6.55,3.34
0125,2012,23468,1761,931,26160,89.71,6.73,3.56
0125,2013,23599,1809,947,26355,89.54,6.86,3.59
0125,2014,23826,1869,1003,26698,89.24,7.00,3.76
0125,2015,24028,1923,1033,26984,89.05,7.13,3.83
0125,2016,24249,2018,1139,27406,88.48,7.36,4.16
0125,2017,24408,2057,1288,27753,87.95,7.41,4.64
0125,2018,24577,2216,1515,28308,86.82,7.83,5.35
0125,2019,24666,2456,1568,28690,85.97,8.56,5.47
0125,2020,24754,2578,1547,28879,85.72,8.93,5.36
0125,2021,24981,2503,1612,29096,85.86,8.60,5.54
0125,2022,24983,2531,1609,29123,85.78,8.69,5.52
0125,2023,24857,2336,1615,28808,86.29,8.11,5.61
0126,2010,72487,12334,12632,97453,74.38,12.66,12.96
0126,2011,73172,12653,13224,99049,73.87,12.77,13.35
0126,2012,74121,13004,13885,101010,73.38,12.87,13.75
0126,2013,74796,13293,14468,102557,72.93,12.96,14.11
0126,2014,75584,13617,14984,104185,72.55,13.07,14.38
0126,2015,75768,14021,15522,105311,71.95,13.31,14.74
0126,2016,76769,14453,16316,107538,71.39,13.44,15.17
0126,2017,77813,14782,17408,110003,70.74,13.44,15.83
0126,2018,78180,15123,18419,111722,69.98,13.54,16.49
0126,2019,78536,15363,18949,112848,69.59,13.61,16.79
0126,2020,78586,15356,19292,113234,69.40,13.56,17.04
0126,2021,78855,15468,19628,113951,69.20,13.57,17.22
0126,2022,78677,15672,20155,114504,68.71,13.69,17.60
0126,2023,78286,15617,20017,113920,68.72,13.71,17.57
0127,2010,51839,15658,15111,82608,62.75,18.95,18.29
0127,2011,52387,16193,16097,84677,61.87,19.12,19.01
0127,2012,52749,16507,17018,86274,61.14,19.13,19.73
0127,2013,53129,16709,17742,87580,60.66,19.08,20.26
0127,2014,53546,16928,18427,88901,60.23,19.04,20.73
0127,2015,53547,17034,18844,89425,59.88,19.05,21.07
0127,2016,53703,17224,19748,90675,59.23,19.00,21.78
0127,2017,53795,17415,20715,91925,58.52,18.94,22.53
0127,2018,53903,17523,21680,93106,57.89,18.82,23.29
0127,2019,53981,17783,22842,94606,57.06,18.80,24.14
0127,2020,53967,17569,23311,94847,56.90,18.52,24.58
0127,2021,53985,17445,23888,95318,56.64,18.30,25.06
0127,2022,53740,17550,24093,95383,56.34,18.40,25.26
0127,2023,53539,17546,24507,95592,56.01,18.36,25.64
0128,2010,13099,1273,1019,15391,85.11,8.27,6.62
0128,2011,13296,1317,1081,15694,84.72,8.39,6.89
0128,2012,13397,1342,1142,15881,84.36,8.45,7.19
0128,2013,13392,1405,1204,16001,83.69,8.78,7.52
0128,2014,13373,1420,1347,16140,82.86,8.80,8.35
0128,2015,13466,1472,1488,16426,81.98,8.96,9.06
0128,2016,13487,1497,1631,16615,81.17,9.01,9.82
0128,2017,13395,1524,1746,16665,80.38,9.14,10.48
0128,2018,13414,1580,1792,16786,79.91,9.41,10.68
0128,2019,13277,1596,1877,16750,79.27,9.53,11.21
0128,2020,13313,1619,2027,16959,78.50,9.55,11.95
0128,2021,13402,1665,2185,17252,77.68,9.65,12.67
0128,2022,13388,1708,2256,17352,77.16,9.84,13.00
0128,2023,13344,1755,2352,17451,76.47,10.06,13.48
0136,2010,60392,9820,6842,77054,78.38,12.74,8.88
0136,2011,60849,10175,7302,78326,77.69,12.99,9.32
0136,2012,61261,10421,7748,79430,77.13,13.12,9.75
0136,2013,62014,10860,8058,80932,76.62,13.42,9.96
0136,2014,62603,11228,8576,82407,75.97,13.63,10.41
0136,2015,63317,11583,8966,83866,75.50,13.81,10.69
0136,2016,63916,12086,9691,85693,74.59,14.10,11.31
0136,2017,64834,12670,10533,88037,73.64,14.39,11.96
0136,2018,65700,13048,11241,89989,73.01,14.50,12.49
0136,2019,66506,13541,12048,92095,72.21,14.70,13.08
0136,2020,67364,13728,12598,93690,71.90,14.65,13.45
0136,2021,68223,14158,13277,95658,71.32,14.80,13.88
0136,2022,68985,14529,14169,97683,70.62,14.87,14.51
0136,2023,69881,14864,15006,99751,70.06,14.90,15.04
0138,2010,36800,3619,2528,42947,85.69,8.43,5.89
0138,2011,37065,3633,2630,43328,85.55,8.38,6.07
0138,2012,37355,3708,2701,43764,85.36,8.47,6.17
0138,2013,37695,3793,2793,44281,85.13,8.57,6.31
0138,2014,38528,3934,2928,45390,84.88,8.67,6.45
0138,2015,39006,4089,3082,46177,84.47,8.86,6.67
0138,2016,39579,4184,3340,47103,84.03,8.88,7.09
0138,2017,39594,4155,3555,47304,83.70,8.78,7.52
0138,2018,39819,4234,3951,48004,82.95,8.82,8.23
0138,2019,39902,4212,4219,48333,82.56,8.71,8.73
0138,2020,40157,4174,4347,48678,82.50,8.57,8.93
0138,2021,40354,4184,4524,49062,82.25,8.53,9.22
0138,2022,40368,4264,4582,49214,82.03,8.66,9.31
0138,2023,40287,4261,4625,49173,81.93,8.67,9.41
0139,2010,18720,2564,2392,23676,79.07,10.83,10.10
0139,2011,18812,2637,2535,23984,78.44,10.99,10.57
0139,2012,19013,2665,2675,24353,78.07,10.94,10.98
0139,2013,19175,2739,2789,24703,77.62,11.09,11.29
0139,2014,19472,2776,3039,25287,77.00,10.98,12.02
0139,2015,19689,2850,3250,25789,76.35,11.05,12.60
0139,2016,20148,2977,3630,26755,75.31,11.13,13.57
0139,2017,20526,3121,3967,27614,74.33,11.30,14.37
0139,2018,20888,3304,4564,28756,72.64,11.49,15.87
0139,2019,20917,3438,4991,29346,71.28,11.72,17.01
0139,2020,21226,3475,5494,30195,70.30,11.51,18.20
0139,2021,21488,3582,6012,31082,69.13,11.52,19.34
0139,2022,21536,3721,6596,31853,67.61,11.68,20.71
0139,2023,21629,3806,7018,32453,66.65,11.73,21.63
0140,2010,8337,765,229,9331,89.35,8.20,2.45
0140,2011,8322,779,230,9331,89.19,8.35,2.46
0140,2012,8421,784,237,9442,89.19,8.30,2.51
0140,2013,8472,793,258,9523,88.96,8.33,2.71
0140,2014,8715,808,292,9815,88.79,8.23,2.98
0140,2015,9042,819,331,10192,88.72,8.04,3.25
0140,2016,9201,849,374,10424,88.27,8.14,3.59
0140,2017,9370,867,423,10660,87.90,8.13,3.97
0140,2018,9572,881,470,10923,87.63,8.07,4.30
0140,2019,9619,886,509,11014,87.33,8.04,4.62
0140,2020,9763,897,562,11222,87.00,7.99,5.01
0140,2021,9946,913,641,11500,86.49,7.94,5.57
0140,2022,10024,934,706,11664,85.94,8.01,6.05
0140,2023,10269,1029,809,12107,84.82,8.50,6.68
0160,2010,54631,5227,3931,63789,85.64,8.19,6.16
0160,2011,55018,5343,4197,64558,85.22,8.28,6.50
0160,2012,55546,5505,4313,65364,84.98,8.42,6.60
0160,2013,56186,5517,4589,66292,84.76,8.32,6.92
0160,2014,56802,5693,4839,67334,84.36,8.45,7.19
0160,2015,57283,5814,5184,68281,83.89,8.51,7.59
0160,2016,57772,5942,5672,69386,83.26,8.56,8.17
0160,2017,58222,6112,6071,70405,82.70,8.68,8.62
0160,2018,58565,6269,6563,71397,82.03,8.78,9.19
0160,2019,58654,6438,6782,71874,81.61,8.96,9.44
0160,2020,59150,6511,7094,72755,81.30,8.95,9.75
0160,2021,59831,6522,7602,73955,80.90,8.82,10.28
0160,2022,60422,6680,8035,75137,80.42,8.89,10.69
0160,2023,61354,6841,8543,76738,79.95,8.91,11.13
0162,2010,26975,2549,1806,31330,86.10,8.14,5.76
0162,2011,27259,2583,1957,31799,85.72,8.12,6.15
0162,2012,27380,2639,1941,31960,85.67,8.26,6.07
0162,2013,27448,2718,2056,32222,85.18,8.44,6.38
0162,2014,27457,2754,2084,32295,85.02,8.53,6.45
0162,2015,27457,2817,2147,32421,84.69,8.69,6.62
0162,2016,27482,2850,2321,32653,84.16,8.73,7.11
0162,2017,27494,2856,2538,32888,83.60,8.68,7.72
0162,2018,27546,2902,2739,33187,83.00,8.74,8.25
0162,2019,27241,2925,2691,32857,82.91,8.90,8.19
0162,2020,27138,2910,2664,32712,82.96,8.90,8.14
0162,2021,27130,2939,2734,32803,82.71,8.96,8.33
0162,2022,26947,3022,2723,32692,82.43,9.24,8.33
0162,2023,26786,2930,2703,32419,82.62,9.04,8.34
0163,2010,52009,5312,7309,64630,80.47,8.22,11.31
0163,2011,52578,5565,7748,65891,79.80,8.45,11.76
0163,2012,52969,5675,8215,66859,79.22,8.49,12.29
0163,2013,53655,5801,8689,68145,78.74,8.51,12.75
0163,2014,53991,6048,9286,69325,77.88,8.72,13.39
0163,2015,54344,6215,9692,70251,77.36,8.85,13.80
0163,2016,54335,6321,10367,71023,76.50,8.90,14.60
0163,2017,54191,6470,11187,71848,75.42,9.01,15.57
0163,2018,54062,6552,11914,72528,74.54,9.03,16.43
0163,2019,54305,6759,12793,73857,73.53,9.15,17.32
0163,2020,54264,6709,13017,73990,73.34,9.07,17.59
0163,2021,54554,6810,13744,75108,72.63,9.07,18.30
0163,2022,54478,6988,14771,76237,71.46,9.17,19.38
0163,2023,54365,7113,15312,76790,70.80,9.26,19.94
0180,2010,659488,82346,105239,847073,77.85,9.72,12.42
0180,2011,669285,84732,110307,864324,77.43,9.80,12.76
0180,2012,679408,86881,114946,881235,77.10,9.86,13.04
0180,2013,689910,88774,119016,897700,76.85,9.89,13.26
0180,2014,698711,91309,121969,911989,76.61,10.01,13.37
0180,2015,705192,93583,124741,923516,76.36,10.13,13.51
0180,2016,710416,95966,129237,935619,75.93,10.26,13.81
0180,2017,715058,98478,136225,949761,75.29,10.37,14.34
0180,2018,719867,100007,142280,962154,74.82,10.39,14.79
0180,2019,725365,101004,147704,974073,74.47,10.37,15.16
0180,2020,726629,100459,148463,975551,74.48,10.30,15.22
0180,2021,726020,100957,151793,978770,74.18,10.31,15.51
0180,2022,726668,103053,155027,984748,73.79,10.46,15.74
0180,2023,729561,103715,155667,988943,73.77,10.49,15.74
0181,2010,58942,12541,14763,86246,68.34,14.54,17.12
0181,2011,58970,12752,15963,87685,67.25,14.54,18.20
0181,2012,59173,13153,17147,89473,66.14,14.70,19.16
0181,2013,59137,13415,18520,91072,64.93,14.73,20.34
0181,2014,58719,13649,19867,92235,63.66,14.80,21.54
0181,2015,58361,13866,20975,93202,62.62,14.88,22.50
0181,2016,58474,14078,22079,94631,61.79,14.88,23.33
0181,2017,58476,14442,23114,96032,60.89,15.04,24.07
0181,2018,58334,14764,24283,97381,59.90,15.16,24.94
0181,2019,58381,15127,25471,98979,58.98,15.28,25.73
0181,2020,58388,15160,26563,100111,58.32,15.14,26.53
0181,2021,58291,15149,27769,101209,57.59,14.97,27.44
0181,2022,58043,15410,28973,102426,56.67,15.05,28.29
0181,2023,57553,15359,29607,102519,56.14,14.98,28.88
0182,2010,74443,8576,7089,90108,82.62,9.52,7.87
0182,2011,75460,8815,7341,91616,82.37,9.62,8.01
0182,2012,76243,9046,7584,92873,82.09,9.74,8.17
0182,2013,77435,9065,7923,94423,82.01,9.60,8.39
0182,2014,78747,9219,8251,96217,81.84,9.58,8.58
0182,2015,79937,9493,8556,97986,81.58,9.69,8.73
0182,2016,80602,9611,9146,99359,81.12,9.67,9.21
0182,2017,81514,9772,9945,101231,80.52,9.65,9.82
0182,2018,83043,10054,10559,103656,80.11,9.70,10.19
0182,2019,84362,10223,10604,105189,80.20,9.72,10.08
0182,2020,85630,10299,10576,106505,80.40,9.67,9.93
0182,2021,86871,10587,10776,108234,80.26,9.78,9.96
0182,2022,87696,10815,10975,109486,80.10,9.88,10.02
0182,2023,88492,10966,11175,110633,79.99,9.91,10.10
0183,2010,28761,3971,5901,38633,74.45,10.28,15.27
0183,2011,29150,4133,6256,39539,73.72,10.45,15.82
0183,2012,29832,4278,6683,40793,73.13,10.49,16.38
0183,2013,30794,4506,7326,42626,72.24,10.57,17.19
0183,2014,31641,4654,7795,44090,71.76,10.56,17.68
0183,2015,32794,4894,8422,46110,71.12,10.61,18.27
0183,2016,33583,5099,9068,47750,70.33,10.68,18.99
0183,2017,34470,5348,9606,49424,69.74,10.82,19.44
0183,2018,35032,5490,10042,50564,69.28,10.86,19.86
0183,2019,35917,5772,10725,52414,68.53,11.01,20.46
0183,2020,36092,5814,10895,52801,68.35,11.01,20.63
0183,2021,36447,5865,11252,53564,68.04,10.95,21.01
0183,2022,36279,6131,11660,54070,67.10,11.34,21.56
0183,2023,37190,6440,12282,55912,66.52,11.52,21.97
0184,2010,51230,7585,9329,68144,75.18,11.13,13.69
0184,2011,52020,7911,10015,69946,74.37,11.31,14.32
0184,2012,52647,8195,10451,71293,73.85,11.49,14.66
0184,2013,53467,8641,10632,72740,73.50,11.88,14.62
0184,2014,53997,9054,10990,74041,72.93,12.23,14.84
0184,2015,55143,9505,11510,76158,72.41,12.48,15.11
0184,2016,55983,9803,12343,78129,71.65,12.55,15.80
0184,2017,56110,10220,13377,79707,70.40,12.82,16.78
0184,2018,56259,10427,14264,80950,69.50,12.88,17.62
0184,2019,56819,10548,15062,82429,68.93,12.80,18.27
0184,2020,56878,10538,15746,83162,68.39,12.67,18.93
0184,2021,56580,10937,16670,84187,67.21,12.99,19.80
0184,2022,56641,11277,17532,85450,66.29,13.20,20.52
0184,2023,56382,11339,17705,85426,66.00,13.27,20.73
0186,2010,37495,3877,2645,44017,85.18,8.81,6.01
0186,2011,37443,3871,2767,44081,84.94,8.78,6.28
0186,2012,37652,3910,2872,44434,84.74,8.80,6.46
0186,2013,38091,4026,3061,45178,84.31,8.91,6.78
0186,2014,38169,4140,3156,45465,83.95,9.11,6.94
0186,2015,38665,4288,3349,46302,83.51,9.26,7.23
0186,2016,38771,4418,3664,46853,82.75,9.43,7.82
0186,2017,38920,4425,3840,47185,82.48,9.38,8.14
0186,2018,39230,4534,4054,47818,82.04,9.48,8.48
0186,2019,39359,4635,4129,48123,81.79,9.63,8.58
0186,2020,39380,4592,4033,48005,82.03,9.57,8.40
0186,2021,39473,4629,4060,48162,81.96,9.61,8.43
0186,2022,39569,4766,4097,48432,81.70,9.84,8.46
0186,2023,39520,4743,4061,48324,81.78,9.81,8.40
0187,2010,9925,640,400,10965,90.52,5.84,3.65
0187,2011,10033,675,433,11141,90.05,6.06,3.89
0187,2012,9993,699,434,11126,89.82,6.28,3.90
0187,2013,10039,706,443,11188,89.73,6.31,3.96
0187,2014,10158,737,434,11329,89.66,6.51,3.83
0187,2015,10210,718,452,11380,89.72,6.31,3.97
0187,2016,10420,697,504,11621,89.67,6.00,4.34
0187,2017,10546,737,548,11831,89.14,6.23,4.63
0187,2018,10684,772,567,12023,88.86,6.42,4.72
0187,2019,10668,777,558,12003,88.88,6.47,4.65
0187,2020,10579,758,549,11886,89.00,6.38,4.62
0187,2021,10668,769,559,11996,88.93,6.41,4.66
0187,2022,10592,775,532,11899,89.02,6.51,4.47
0187,2023,10539,760,518,11817,89.19,6.43,4.38
0188,2010,50625,3796,1659,56080,90.27,6.77,2.96
0188,2011,50686,3817,1742,56245,90.12,6.79,3.10
0188,2012,50912,3895,1827,56634,89.90,6.88,3.23
0188,2013,50980,3922,1943,56845,89.68,6.90,3.42
0188,2014,51428,3982,2158,57568,89.33,6.92,3.75
0188,2015,52070,4162,2437,58669,88.75,7.09,4.15
0188,2016,52443,4275,2702,59420,88.26,7.19,4.55
0188,2017,53249,4487,3072,60808,87.57,7.38,5.05
0188,2018,53779,4548,3442,61769,87.06,7.36,5.57
0188,2019,54296,4647,3679,62622,86.70,7.42,5.87
0188,2020,55072,4760,3841,63673,86.49,7.48,6.03
0188,2021,56040,4821,3901,64762,86.53,7.44,6.02
0188,2022,56609,4970,4008,65587,86.31,7.58,6.11
0188,2023,56724,5011,4035,65770,86.25,7.62,6.14
0191,2010,30609,4329,5052,39990,76.54,10.83,12.63
0191,2011,31063,4636,5630,41329,75.16,11.22,13.62
0191,2012,31246,4844,6182,42272,73.92,11.46,14.62
0191,2013,31562,5071,6739,43372,72.77,11.69,15.54
0191,2014,31558,5238,7289,44085,71.58,11.88,16.53
0191,2015,31493,5450,7843,44786,70.32,12.17,17.51
0191,2016,31897,5679,8698,46274,68.93,12.27,18.80
0191,2017,31878,5837,9431,47146,67.62,12.38,20.00
0191,2018,31886,6042,10202,48130,66.25,12.55,21.20
0191,2019,32027,6141,10796,48964,65.41,12.54,22.05
0191,2020,31955,6163,11419,49537,64.51,12.44,23.05
0191,2021,32087,6229,11957,50273,63.83,12.39,23.78
0191,2022,32427,6519,12930,51876,62.51,12.57,24.92
0191,2023,32381,6658,13490,52529,61.64,12.67,25.68
0192,2010,22625,2209,1198,26032,86.91,8.49,4.60
0192,2011,22684,2313,1251,26248,86.42,8.81,4.77
0192,2012,22811,2431,1330,26572,85.85,9.15,5.01
0192,2013,22861,2524,1411,26796,85.31,9.42,5.27
0192,2014,23017,2590,1434,27041,85.12,9.58,5.30
0192,2015,23197,2763,1540,27500,84.35,10.05,5.60
0192,2016,23233,2872,1647,27752,83.72,10.35,5.93
0192,2017,23260,2907,1942,28109,82.75,10.34,6.91
0192,2018,23216,2960,2114,28290,82.06,10.46,7.47
0192,2019,23270,3070,2235,28575,81.43,10.74,7.82
0192,2020,23326,3142,2343,28811,80.96,10.91,8.13
0192,2021,23621,3255,2619,29495,80.08,11.04,8.88
0192,2022,23830,3412,2801,30043,79.32,11.36,9.32
0192,2023,23952,3477,2882,30311,79.02,11.47,9.51
0305,2010,17201,1726,702,19629,87.63,8.79,3.58
0305,2011,17225,1733,757,19715,87.37,8.79,3.84
0305,2012,17312,1775,796,19883,87.07,8.93,4.00
0305,2013,17332,1820,816,19968,86.80,9.11,4.09
0305,2014,17368,1815,851,20034,86.69,9.06,4.25
0305,2015,17540,1813,926,20279,86.49,8.94,4.57
0305,2016,17789,1847,1101,20737,85.78,8.91,5.31
0305,2017,17962,1893,1228,21083,85.20,8.98,5.82
0305,2018,18231,1960,1373,21564,84.54,9.09,6.37
0305,2019,18449,2014,1471,21934,84.11,9.18,6.71
0305,2020,18554,2033,1432,22019,84.26,9.23,6.50
0305,2021,18778,2069,1497,22344,84.04,9.26,6.70
0305,2022,19022,2146,1597,22765,83.56,9.43,7.02
0305,2023,19110,2148,1716,22974,83.18,9.35,7.47
0319,2010,8203,513,387,9103,90.11,5.64,4.25
0319,2011,8142,508,439,9089,89.58,5.59,4.83
0319,2012,8080,507,472,9059,89.19,5.60,5.21
0319,2013,8122,507,503,9132,88.94,5.55,5.51
0319,2014,8081,516,572,9169,88.13,5.63,6.24
0319,2015,8049,525,719,9293,86.61,5.65,7.74
0319,2016,8037,525,883,9445,85.09,5.56,9.35
0319,2017,7995,505,902,9402,85.04,5.37,9.59
0319,2018,7954,499,939,9392,84.69,5.31,10.00
0319,2019,8011,502,944,9457,84.71,5.31,9.98
0319,2020,8091,502,918,9511,85.07,5.28,9.65
0319,2021,8209,523,895,9627,85.27,5.43,9.30
0319,2022,8203,526,896,9625,85.23,5.46,9.31
0319,2023,8170,526,876,9572,85.35,5.50,9.15
0330,2010,13383,784,557,14724,90.89,5.32,3.78
0330,2011,13565,811,589,14965,90.64,5.42,3.94
0330,2012,13788,847,644,15279,90.24,5.54,4.21
0330,2013,13991,899,690,15580,89.80,5.77,4.43
0330,2014,14424,926,755,16105,89.56,5.75,4.69
0330,2015,14985,1032,852,16869,88.83,6.12,5.05
0330,2016,15270,1086,967,17323,88.15,6.27,5.58
0330,2017,15751,1183,1130,18064,87.20,6.55,6.26
0330,2018,16176,1265,1279,18720,86.41,6.76,6.83
0330,2019,16212,1283,1340,18835,86.07,6.81,7.11
0330,2020,16349,1351,1406,19106,85.57,7.07,7.36
0330,2021,16786,1452,1580,19818,84.70,7.33,7.97
0330,2022,16944,1503,1686,20133,84.16,7.47,8.37
0330,2023,17276,1602,1836,20714,83.40,7.73,8.86
0331,2010,12259,728,395,13382,91.61,5.44,2.95
0331,2011,12228,750,403,13381,91.38,5.60,3.01
0331,2012,12210,756,398,13364,91.36,5.66,2.98
0331,2013,12223,791,436,13450,90.88,5.88,3.24
0331,2014,12179,815,496,13490,90.28,6.04,3.68
0331,2015,12187,820,587,13594,89.65,6.03,4.32
0331,2016,12243,833,679,13755,89.01,6.06,4.94
0331,2017,12253,869,732,13854,88.44,6.27,5.28
0331,2018,12247,900,763,13910,88.04,6.47,5.49
0331,2019,12278,932,837,14047,87.41,6.63,5.96
0331,2020,12328,919,854,14101,87.43,6.52,6.06
0331,2021,12467,928,908,14303,87.16,6.49,6.35
0331,2022,12505,958,958,14421,86.71,6.64,6.64
0331,2023,12425,983,935,14343,86.63,6.85,6.52
0360,2010,18522,919,684,20125,92.03,4.57,3.40
0360,2011,18415,946,716,20077,91.72,4.71,3.57
0360,2012,18419,1004,733,20156,91.38,4.98,3.64
0360,2013,18338,1028,778,20144,91.03,5.10,3.86
0360,2014,18314,1041,890,20245,90.46,5.14,4.40
0360,2015,18397,1052,1098,20547,89.54,5.12,5.34
0360,2016,18420,1044,1280,20744,88.80,5.03,6.17
0360,2017,18422,1082,1426,20930,88.02,5.17,6.81
0360,2018,18481,1077,1569,21127,87.48,5.10,7.43
0360,2019,18461,1076,1599,21136,87.34,5.09,7.57
0360,2020,18525,1045,1757,21327,86.86,4.90,8.24
0360,2021,18616,1051,1818,21485,86.65,4.89,8.46
0360,2022,18569,1063,1774,21406,86.75,4.97,8.29
0360,2023,18421,1087,1685,21193,86.92,5.13,7.95
0380,2010,165368,12870,19549,197787,83.61,6.51,9.88
0380,2011,166604,13212,20185,200001,83.30,6.61,10.09
0380,2012,168456,13537,20632,202625,83.14,6.68,10.18
0380,2013,169806,14014,21379,205199,82.75,6.83,10.42
0380,2014,171089,14542,21731,207362,82.51,7.01,10.48
0380,2015,172293,15080,22753,210126,82.00,7.18,10.83
0380,2016,173868,15841,24850,214559,81.04,7.38,11.58
0380,2017,175551,16739,27624,219914,79.83,7.61,12.56
0380,2018,177667,17392,30105,225164,78.91,7.72,13.37
0380,2019,180362,17802,32603,230767,78.16,7.71,14.13
0380,2020,182158,18005,33676,233839,77.90,7.70,14.40
0380,2021,184151,18408,35037,237596,77.51,7.75,14.75
0380,2022,186416,19027,36697,242140,76.99,7.86,15.16
0380,2023,188591,19454,37284,245329,76.87,7.93,15.20
0381,2010,35570,2585,1604,39759,89.46,6.50,4.03
0381,2011,35726,2583,1706,40015,89.28,6.46,4.26
0381,2012,35995,2600,1754,40349,89.21,6.44,4.35
0381,2013,36038,2627,1991,40656,88.64,6.46,4.90
0381,2014,36317,2630,2216,41163,88.23,6.39,5.38
0381,2015,36667,2654,2572,41893,87.53,6.34,6.14
0381,2016,37159,2752,3077,42988,86.44,6.40,7.16
0381,2017,37528,2815,3454,43797,85.69,6.43,7.89
0381,2018,37799,2854,3776,44429,85.08,6.42,8.50
0381,2019,38273,2901,4113,45287,84.51,6.41,9.08
0381,2020,38787,2947,4506,46240,83.88,6.37,9.74
0381,2021,39497,3009,4983,47489,83.17,6.34,10.49
0381,2022,39653,3053,5142,47848,82.87,6.38,10.75
0381,2023,39973,3103,5216,48292,82.77,6.43,10.80
0382,2010,19730,1203,440,21373,92.31,5.63,2.06
0382,2011,19727,1197,463,21387,92.24,5.60,2.16
0382,2012,19610,1166,486,21262,92.23,5.48,2.29
0382,2013,19668,1178,506,21352,92.11,5.52,2.37
0382,2014,19659,1163,552,21374,91.98,5.44,2.58
0382,2015,19755,1179,629,21563,91.62,5.47,2.92
0382,2016,19889,1185,748,21822,91.14,5.43,3.43
0382,2017,19916,1203,808,21927,90.83,5.49,3.68
0382,2018,19948,1216,884,22048,90.48,5.52,4.01
0382,2019,20112,1207,931,22250,90.39,5.42,4.18
0382,2020,20120,1189,942,22251,90.42,5.34,4.23
0382,2021,20163,1201,1000,22364,90.16,5.37,4.47
0382,2022,20096,1229,1019,22344,89.94,5.50,4.56
0382,2023,19956,1207,1009,22172,90.01,5.44,4.55
0428,2010,8137,436,320,8893,91.50,4.90,3.60
0428,2011,8017,436,371,8824,90.85,4.94,4.20
0428,2012,7913,433,429,8775,90.18,4.93,4.89
0428,2013,7815,413,607,8835,88.46,4.67,6.87
0428,2014,7819,423,677,8919,87.67,4.74,7.59
0428,2015,7846,421,686,8953,87.64,4.70,7.66
0428,2016,7867,414,818,9099,86.46,4.55,8.99
0428,2017,7825,428,927,9180,85.24,4.66,10.10
0428,2018,7771,430,935,9136,85.06,4.71,10.23
0428,2019,7749,430,932,9111,85.05,4.72,10.23
0428,2020,7766,427,951,9144,84.93,4.67,10.40
0428,2021,7748,424,891,9063,85.49,4.68,9.83
0428,2022,7721,427,833,8981,85.97,4.75,9.28
0428,2023,7631,429,796,8856,86.17,4.84,8.99
0461,2010,9401,651,308,10360,90.74,6.28,2.97
0461,2011,9373,640,332,10345,90.60,6.19,3.21
0461,2012,9419,674,349,10442,90.20,6.45,3.34
0461,2013,9352,695,362,10409,89.85,6.68,3.48
0461,2014,9389,728,396,10513,89.31,6.92,3.77
0461,2015,9452,761,436,10649,88.76,7.15,4.09
0461,2016,9537,772,552,10861,87.81,7.11,5.08
0461,2017,9643,799,577,11019,87.51,7.25,5.24
0461,2018,9803,814,620,11237,87.24,7.24,5.52
0461,2019,9871,838,656,11365,86.85,7.37,5.77
0461,2020,9901,863,657,11421,86.69,7.56,5.75
0461,2021,9970,876,667,11513,86.60,7.61,5.79
0461,2022,10042,895,675,11612,86.48,7.71,5.81
0461,2023,9948,892,680,11520,86.35,7.74,5.90
0480,2010,46149,3013,2482,51644,89.36,5.83,4.81
0480,2011,46316,3016,2564,51896,89.25,5.81,4.94
0480,2012,46529,3068,2739,52336,88.90,5.86,5.23
0480,2013,46702,3138,3198,53038,88.05,5.92,6.03
0480,2014,46837,3169,3502,53508,87.53,5.92,6.54
0480,2015,47070,3318,3874,54262,86.75,6.11,7.14
0480,2016,47135,3402,4387,54924,85.82,6.19,7.99
0480,2017,47250,3471,4746,55467,85.19,6.26,8.56
0480,2018,47466,3499,5046,56011,84.74,6.25,9.01
0480,2019,47696,3492,5403,56591,84.28,6.17,9.55
0480,2020,47889,3520,5662,57071,83.91,6.17,9.92
0480,2021,48241,3558,5834,57633,83.70,6.17,10.12
0480,2022,48457,3630,5934,58021,83.52,6.26,10.23
0480,2023,48528,3680,5992,58200,83.38,6.32,10.30
0481,2010,9486,1190,517,11193,84.75,10.63,4.62
0481,2011,9495,1205,550,11250,84.40,10.71,4.89
0481,2012,9434,1198,604,11236,83.96,10.66,5.38
0481,2013,9482,1215,706,11403,83.15,10.66,6.19
0481,2014,9441,1181,929,11551,81.73,10.22,8.04
0481,2015,9365,1197,1139,11701,80.04,10.23,9.73
0481,2016,9336,1188,1397,11921,78.32,9.97,11.72
0481,2017,9371,1176,1461,12008,78.04,9.79,12.17
0481,2018,9339,1168,1555,12062,77.42,9.68,12.89
0481,2019,9280,1154,1549,11983,77.44,9.63,12.93
0481,2020,9295,1105,1595,11995,77.49,9.21,13.30
0481,2021,9430,1121,1581,12132,77.73,9.24,13.03
0481,2022,9442,1118,1526,12086,78.12,9.25,12.63
0481,2023,9511,1102,1493,12106,78.56,9.10,12.33
0482,2010,13675,1336,1017,16028,85.32,8.34,6.35
0482,2011,13569,1369,1125,16063,84.47,8.52,7.00
0482,2012,13435,1402,1182,16019,83.87,8.75,7.38
0482,2013,13300,1436,1420,16156,82.32,8.89,8.79
0482,2014,13194,1440,1608,16242,81.23,8.87,9.90
0482,2015,13077,1445,1918,16440,79.54,8.79,11.67
0482,2016,13023,1461,2346,16830,77.38,8.68,13.94
0482,2017,12954,1466,2444,16864,76.81,8.69,14.49
0482,2018,12838,1461,2406,16705,76.85,8.75,14.40
0482,2019,12724,1461,2400,16585,76.72,8.81,14.47
0482,2020,12651,1442,2338,16431,76.99,8.78,14.23
0482,2021,12556,1428,2332,16316,76.96,8.75,14.29
0482,2022,12442,1402,2214,16058,77.48,8.73,13.79
0482,2023,12267,1379,2022,15668,78.29,8.80,12.91
0483,2010,27920,2178,2330,32428,86.10,6.72,7.19
0483,2011,27862,2151,2396,32409,85.97,6.64,7.39
0483,2012,27858,2133,2558,32549,85.59,6.55,7.86
0483,2013,27934,2142,2854,32930,84.83,6.50,8.67
0483,2014,27932,2147,3189,33268,83.96,6.45,9.59
0483,2015,27888,2130,3444,33462,83.34,6.37,10.29
0483,2016,27846,2106,3770,33722,82.58,6.25,11.18
0483,2017,27909,2104,4120,34133,81.77,6.16,12.07
0483,2018,27981,2132,4437,34550,80.99,6.17,12.84
0483,2019,28029,2137,4589,34755,80.65,6.15,13.20
0483,2020,28046,2091,4628,34765,80.67,6.01,13.31
0483,2021,28040,2072,4652,34764,80.66,5.96,13.38
0483,2022,27930,2100,4574,34604,80.71,6.07,13.22
0483,2023,27714,2066,4544,34324,80.74,6.02,13.24
0484,2010,77287,9121,9903,96311,80.25,9.47,10.28
0484,2011,77710,9057,10829,97596,79.62,9.28,11.10
0484,2012,78013,8975,11777,98765,78.99,9.09,11.92
0484,2013,78082,8858,12789,99729,78.29,8.88,12.82
0484,2014,78116,8717,14090,100923,77.40,8.64,13.96
0484,2015,78221,8661,15183,102065,76.64,8.49,14.88
0484,2016,78446,8620,16618,103684,75.66,8.31,16.03
0484,2017,78519,8632,17558,104709,74.99,8.24,16.77
0484,2018,78729,8618,18577,105924,74.33,8.14,17.54
0484,2019,78903,8477,19479,106859,73.84,7.93,18.23
0484,2020,78849,8348,19778,106975,73.71,7.80,18.49
0484,2021,79096,8267,20230,107593,73.51,7.68,18.80
0484,2022,79108,8256,20554,107918,73.30,7.65,19.05
0484,2023,78655,8118,20695,107468,73.19,7.55,19.26
0486,2010,28904,2423,1092,32419,89.16,7.47,3.37
0486,2011,29026,2477,1184,32687,88.80,7.58,3.62
0486,2012,29287,2517,1268,33072,88.56,7.61,3.83
0486,2013,29397,2571,1421,33389,88.04,7.70,4.26
0486,2014,29671,2599,1608,33878,87.58,7.67,4.75
0486,2015,29739,2648,1715,34102,87.21,7.76,5.03
0486,2016,29872,2742,1995,34609,86.31,7.92,5.76
0486,2017,30056,2886,2103,35045,85.76,8.24,6.00
0486,2018,30421,3042,2298,35761,85.07,8.51,6.43
0486,2019,30917,3105,2522,36544,84.60,8.50,6.90
0486,2020,31358,3184,2748,37290,84.09,8.54,7.37
0486,2021,31854,3298,2977,38129,83.54,8.65,7.81
0486,2022,32136,3388,3002,38526,83.41,8.79,7.79
0486,2023,32411,3446,3060,38917,83.28,8.85,7.86
0488,2010,10228,990,244,11462,89.23,8.64,2.13
0488,2011,10261,980,252,11493,89.28,8.53,2.19
0488,2012,10271,990,268,11529,89.09,8.59,2.32
0488,2013,10350,1031,299,11680,88.61,8.83,2.56
0488,2014,10464,1056,344,11864,88.20,8.90,2.90
0488,2015,10636,1059,383,12078,88.06,8.77,3.17
0488,2016,10823,1148,476,12447,86.95,9.22,3.82
0488,2017,11181,1208,527,12916,86.57,9.35,4.08
0488,2018,11475,1236,598,13309,86.22,9.29,4.49
0488,2019,11781,1261,705,13747,85.70,9.17,5.13
0488,2020,12203,1304,802,14309,85.28,9.11,5.60
0488,2021,12486,1368,804,14658,85.18,9.33,5.49
0488,2022,12567,1381,812,14760,85.14,9.36,5.50
0488,2023,12697,1397,791,14885,85.30,9.39,5.31
0509,2010,4927,250,107,5284,93.24,4.73,2.02
0509,2011,4875,257,113,5245,92.95,4.90,2.15
0509,2012,4807,260,133,5200,92.44,5.00,2.56
0509,2013,4753,275,146,5174,91.86,5.32,2.82
0509,2014,4779,276,185,5240,91.20,5.27,3.53
0509,2015,4743,278,215,5236,90.58,5.31,4.11
0509,2016,4764,281,290,5335,89.30,5.27,5.44
0509,2017,4718,299,326,5343,88.30,5.60,6.10
0509,2018,4679,311,333,5323,87.90,5.84,6.26
0509,2019,4719,313,305,5337,88.42,5.86,5.71
0509,2020,4721,323,294,5338,88.44,6.05,5.51
0509,2021,4710,320,279,5309,88.72,6.03,5.26
0509,2022,4710,335,272,5317,88.58,6.30,5.12
0509,2023,4683,344,252,5279,88.71,6.52,4.77
0512,2010,3432,185,55,3672,93.46,5.04,1.50
0512,2011,3396,196,74,3666,92.64,5.35,2.02
0512,2012,3353,195,64,3612,92.83,5.40,1.77
0512,2013,3322,207,88,3617,91.84,5.72,2.43
0512,2014,3339,214,107,3660,91.23,5.85,2.92
0512,2015,3325,202,131,3658,90.90,5.52,3.58
0512,2016,3323,203,149,3675,90.42,5.52,4.05
0512,2017,3354,208,171,3733,89.85,5.57,4.58
0512,2018,3350,207,186,3743,89.50,5.53,4.97
0512,2019,3368,202,177,3747,89.89,5.39,4.72
0512,2020,3358,210,158,3726,90.12,5.64,4.24
0512,2021,3328,217,150,3695,90.07,5.87,4.06
0512,2022,3301,218,164,3683,89.63,5.92,4.45
0512,2023,3270,231,136,3637,89.91,6.35,3.74
0513,2010,9193,331,238,9762,94.17,3.39,2.44
0513,2011,9185,342,272,9799,93.73,3.49,2.78
0513,2012,9097,346,301,9744,93.36,3.55,3.09
0513,2013,9064,367,371,9802,92.47,3.74,3.78
0513,2014,9018,374,403,9795,92.07,3.82,4.11
0513,2015,8995,367,433,9795,91.83,3.75,4.42
0513,2016,9042,364,468,9874,91.57,3.69,4.74
0513,2017,9002,363,517,9882,91.09,3.67,5.23
0513,2018,9010,373,532,9915,90.87,3.76,5.37
0513,2019,9034,374,532,9940,90.89,3.76,5.35
0513,2020,9080,377,534,9991,90.88,3.77,5.34
0513,2021,9136,374,538,10048,90.92,3.72,5.35
0513,2022,9125,377,566,10068,90.63,3.74,5.62
0513,2023,9043,383,566,9992,90.50,3.83,5.66
0560,2010,4958,152,111,5221,94.96,2.91,2.13
0560,2011,4930,164,111,5205,94.72,3.15,2.13
0560,2012,4905,164,137,5206,94.22,3.15,2.63
0560,2013,4924,172,182,5278,93.29,3.26,3.45
0560,2014,4946,173,203,5322,92.93,3.25,3.81
0560,2015,4936,163,229,5328,92.64,3.06,4.30
0560,2016,4944,157,272,5373,92.02,2.92,5.06
0560,2017,4975,174,304,5453,91.23,3.19,5.57
0560,2018,4944,191,314,5449,90.73,3.51,5.76
0560,2019,4960,193,323,5476,90.58,3.52,5.90
0560,2020,4936,208,297,5441,90.72,3.82,5.46
0560,2021,4975,237,300,5512,90.26,4.30,5.44
0560,2022,4962,253,283,5498,90.25,4.60,5.15
0560,2023,4972,267,284,5523,90.02,4.83,5.14
0561,2010,10932,324,248,11504,95.03,2.82,2.16
0561,2011,10898,350,269,11517,94.63,3.04,2.34
0561,2012,10827,351,268,11446,94.59,3.07,2.34
0561,2013,10808,372,280,11460,94.31,3.25,2.44
0561,2014,10739,389,344,11472,93.61,3.39,3.00
0561,2015,10736,389,420,11545,92.99,3.37,3.64
0561,2016,10742,387,488,11617,92.47,3.33,4.20
0561,2017,10703,398,530,11631,92.02,3.42,4.56
0561,2018,10646,393,498,11537,92.28,3.41,4.32
0561,2019,10589,401,513,11503,92.05,3.49,4.46
0561,2020,10536,394,497,11427,92.20,3.45,4.35
0561,2021,10556,390,516,11462,92.10,3.40,4.50
0561,2022,10582,395,529,11506,91.97,3.43,4.60
0561,2023,10546,405,509,11460,92.02,3.53,4.44
0562,2010,18510,1595,642,20747,89.22,7.69,3.09
0562,2011,18493,1577,693,20763,89.07,7.60,3.34
0562,2012,18393,1591,807,20791,88.47,7.65,3.88
0562,2013,18326,1614,963,20903,87.67,7.72,4.61
0562,2014,18372,1622,1156,21150,86.87,7.67,5.47
0562,2015,18270,1606,1323,21199,86.18,7.58,6.24
0562,2016,18311,1643,1572,21526,85.06,7.63,7.30
0562,2017,18362,1655,1560,21577,85.10,7.67,7.23
0562,2018,18403,1661,1694,21758,84.58,7.63,7.79
0562,2019,18404,1649,1859,21912,83.99,7.53,8.48
0562,2020,18268,1645,1852,21765,83.93,7.56,8.51
0562,2021,18316,1647,1926,21889,83.68,7.52,8.80
0562,2022,18271,1698,1934,21903,83.42,7.75,8.83
0562,2023,18066,1667,1961,21694,83.28,7.68,9.04
0563,2010,7254,286,220,7760,93.48,3.69,2.84
0563,2011,7137,275,250,7662,93.15,3.59,3.26
0563,2012,7079,297,221,7597,93.18,3.91,2.91
0563,2013,7035,272,278,7585,92.75,3.59,3.67
0563,2014,7052,283,322,7657,92.10,3.70,4.21
0563,2015,7004,289,454,7747,90.41,3.73,5.86
0563,2016,6927,304,578,7809,88.71,3.89,7.40
0563,2017,6916,317,687,7920,87.32,4.00,8.67
0563,2018,6918,329,709,7956,86.95,4.14,8.91
0563,2019,6886,331,656,7873,87.46,4.20,8.33
0563,2020,6876,331,530,7737,88.87,4.28,6.85
0563,2021,6838,333,489,7660,89.27,4.35,6.38
0563,2022,6831,348,451,7630,89.53,4.56,5.91
0563,2023,6769,345,427,7541,89.76,4.57,5.66
0580,2010,126438,7542,12436,146416,86.36,5.15,8.49
0580,2011,126902,7700,12732,147334,86.13,5.23,8.64
0580,2012,127582,7928,13011,148521,85.90,5.34,8.76
0580,2013,128545,8098,13559,150202,85.58,5.39,9.03
0580,2014,129398,8365,14118,151881,85.20,5.51,9.30
0580,2015,130021,8567,14378,152966,85.00,5.60,9.40
0580,2016,131247,8996,15574,155817,84.23,5.77,10.00
0580,2017,132339,9416,16765,158520,83.48,5.94,10.58
0580,2018,133379,9625,18030,161034,82.83,5.98,11.20
0580,2019,134236,9747,19068,163051,82.33,5.98,11.69
0580,2020,135112,9754,19750,164616,82.08,5.93,12.00
0580,2021,135225,9924,20378,165527,81.69,6.00,12.31
0580,2022,135513,10167,20993,166673,81.30,6.10,12.60
0580,2023,136008,10249,21147,167404,81.25,6.12,12.63
0581,2010,110423,10333,9294,130050,84.91,7.95,7.15
0581,2011,110675,10357,9591,130623,84.73,7.93,7.34
0581,2012,111421,10399,10304,132124,84.33,7.87,7.80
0581,2013,111844,10486,11419,133749,83.62,7.84,8.54
0581,2014,112148,10572,12563,135283,82.90,7.81,9.29
0581,2015,112640,10715,13680,137035,82.20,7.82,9.98
0581,2016,113125,10957,15281,139363,81.17,7.86,10.96
0581,2017,113454,11113,16360,140927,80.51,7.89,11.61
0581,2018,113445,11214,17017,141676,80.07,7.92,12.01
0581,2019,114036,11396,17739,143171,79.65,7.96,12.39
0581,2020,114053,11326,18099,143478,79.49,7.89,12.61
0581,2021,114512,11275,18671,144458,79.27,7.81,12.92
0581,2022,114684,11370,19066,145120,79.03,7.83,13.14
0581,2023,114504,11410,19249,145163,78.88,7.86,13.26
0582,2010,13323,446,255,14024,95.00,3.18,1.82
0582,2011,13333,455,255,14043,94.94,3.24,1.82
0582,2012,13406,464,273,14143,94.79,3.28,1.93
0582,2013,13440,467,288,14195,94.68,3.29,2.03
0582,2014,13495,467,306,14268,94.58,3.27,2.14
0582,2015,13448,470,322,14240,94.44,3.30,2.26
0582,2016,13497,502,403,14402,93.72,3.49,2.80
0582,2017,13556,505,460,14521,93.35,3.48,3.17
0582,2018,13575,529,514,14618,92.86,3.62,3.52
0582,2019,13542,513,571,14626,92.59,3.51,3.90
0582,2020,13572,480,564,14616,92.86,3.28,3.86
0582,2021,13608,493,572,14673,92.74,3.36,3.90
0582,2022,13749,494,591,14834,92.69,3.33,3.98
0582,2023,13790,521,556,14867,92.76,3.50,3.74
0583,2010,37617,2592,1746,41955,89.66,6.18,4.16
0583,2011,37463,2582,1783,41828,89.56,6.17,4.26
0583,2012,37330,2590,1947,41867,89.16,6.19,4.65
0583,2013,37287,2586,2314,42187,88.39,6.13,5.49
0583,2014,37279,2572,2705,42556,87.60,6.04,6.36
0583,2015,37173,2604,3126,42903,86.64,6.07,7.29
0583,2016,37139,2648,3471,43258,85.85,6.12,8.02
0583,2017,37158,2641,3750,43549,85.32,6.06,8.61
0583,2018,37107,2604,3976,43687,84.94,5.96,9.10
0583,2019,37044,2570,4059,43673,84.82,5.88,9.29
0583,2020,36993,2542,4105,43640,84.77,5.82,9.41
0583,2021,36992,2527,4155,43674,84.70,5.79,9.51
0583,2022,37046,2523,4159,43728,84.72,5.77,9.51
0583,2023,37073,2519,4136,43728,84.78,5.76,9.46
0584,2010,6885,352,154,7391,93.15,4.76,2.08
0584,2011,6793,363,161,7317,92.84,4.96,2.20
0584,2012,6810,371,157,7338,92.80,5.06,2.14
0584,2013,6823,392,168,7383,92.42,5.31,2.28
0584,2014,6824,380,189,7393,92.30,5.14,2.56
0584,2015,6818,367,222,7407,92.05,4.95,3.00
0584,2016,6716,381,251,7348,91.40,5.19,3.42
0584,2017,6751,375,295,7421,90.97,5.05,3.98
0584,2018,6829,364,321,7514,90.88,4.84,4.27
0584,2019,6770,355,303,7428,91.14,4.78,4.08
0584,2020,6783,347,293,7423,91.38,4.67,3.95
0584,2021,6880,352,296,7528,91.39,4.68,3.93
0584,2022,6827,359,295,7481,91.26,4.80,3.94
0584,2023,6772,366,296,7434,91.09,4.92,3.98
0586,2010,24081,959,816,25856,93.14,3.71,3.16
0586,2011,24197,1021,855,26073,92.80,3.92,3.28
0586,2012,24240,1021,934,26195,92.54,3.90,3.57
0586,2013,24280,1019,1014,26313,92.27,3.87,3.85
0586,2014,24271,1026,1131,26428,91.84,3.88,4.28
0586,2015,24297,1041,1264,26602,91.34,3.91,4.75
0586,2016,24206,1062,1440,26708,90.63,3.98,5.39
0586,2017,24216,1131,1672,27019,89.63,4.19,6.19
0586,2018,24372,1164,1837,27373,89.04,4.25,6.71
0586,2019,24541,1203,2014,27758,88.41,4.33,7.26
0586,2020,24649,1229,2082,27960,88.16,4.40,7.45
0586,2021,24870,1231,2168,28269,87.98,4.35,7.67
0586,2022,24923,1252,2296,28471,87.54,4.40,8.06
0586,2023,24970,1266,2340,28576,87.38,4.43,8.19
0604,2010,5909,325,159,6393,92.43,5.08,2.49
0604,2011,5891,337,187,6415,91.83,5.25,2.92
0604,2012,5878,335,194,6407,91.74,5.23,3.03
0604,2013,5849,329,197,6375,91.75,5.16,3.09
0604,2014,5832,346,248,6426,90.76,5.38,3.86
0604,2015,5854,357,326,6537,89.55,5.46,4.99
0604,2016,5862,363,378,6603,88.78,5.50,5.72
0604,2017,5943,369,464,6776,87.71,5.45,6.85
0604,2018,5962,375,495,6832,87.27,5.49,7.25
0604,2019,5952,398,498,6848,86.92,5.81,7.27
0604,2020,5923,399,499,6821,86.83,5.85,7.32
0604,2021,5959,409,524,6892,86.46,5.93,7.60
0604,2022,5923,415,486,6824,86.80,6.08,7.12
0604,2023,5934,435,483,6852,86.60,6.35,7.05
0617,2010,7671,1106,769,9546,80.36,11.59,8.06
0617,2011,7540,1094,766,9400,80.21,11.64,8.15
0617,2012,7450,1118,786,9354,79.65,11.95,8.40
0617,2013,7404,1131,871,9406,78.72,12.02,9.26
0617,2014,7369,1124,1016,9509,77.50,11.82,10.68
0617,2015,7286,1148,1080,9514,76.58,12.07,11.35
0617,2016,7274,1167,1174,9615,75.65,12.14,12.21
0617,2017,7290,1189,1254,9733,74.90,12.22,12.88
0617,2018,7277,1216,1283,9776,74.44,12.44,13.12
0617,2019,7204,1230,1278,9712,74.18,12.66,13.16
0617,2020,7112,1230,1272,9614,73.98,12.79,13.23
0617,2021,7092,1212,1266,9570,74.11,12.66,13.23
0617,2022,6976,1215,1247,9438,73.91,12.87,13.21
0617,2023,6849,1206,1191,9246,74.08,13.04,12.88
0642,2010,6467,391,175,7033,91.95,5.56,2.49
0642,2011,6460,392,182,7034,91.84,5.57,2.59
0642,2012,6500,392,178,7070,91.94,5.54,2.52
0642,2013,6462,390,187,7039,91.80,5.54,2.66
0642,2014,6491,403,215,7109,91.31,5.67,3.02
0642,2015,6498,404,255,7157,90.79,5.64,3.56
0642,2016,6526,404,296,7226,90.31,5.59,4.10
0642,2017,6540,431,357,7328,89.25,5.88,4.87
0642,2018,6530,417,377,7324,89.16,5.69,5.15
0642,2019,6488,424,378,7290,89.00,5.82,5.19
0642,2020,6535,461,389,7385,88.49,6.24,5.27
0642,2021,6572,472,386,7430,88.45,6.35,5.20
0642,2022,6637,487,408,7532,88.12,6.47,5.42
0642,2023,6665,494,418,7577,87.96,6.52,5.52
0643,2010,10103,392,246,10741,94.06,3.65,2.29
0643,2011,10178,392,258,10828,94.00,3.62,2.38
0643,2012,10212,373,294,10879,93.87,3.43,2.70
0643,2013,10291,379,305,10975,93.77,3.45,2.78
0643,2014,10399,399,312,11110,93.60,3.59,2.81
0643,2015,10586,403,325,11314,93.57,3.56,2.87
0643,2016,10782,406,398,11586,93.06,3.50,3.44
0643,2017,10944,423,478,11845,92.39,3.57,4.04
0643,2018,11153,451,536,12140,91.87,3.71,4.42
0643,2019,11393,462,578,12433,91.64,3.72,4.65
0643,2020,11555,460,574,12589,91.79,3.65,4.56
0643,2021,11736,470,604,12810,91.62,3.67,4.72
0643,2022,12022,500,606,13128,91.58,3.81,4.62
0643,2023,12146,512,617,13275,91.50,3.86,4.65
0662,2010,24230,3609,1272,29111,83.23,12.40,4.37
0662,2011,24010,3614,1244,28868,83.17,12.52,4.31
0662,2012,23796,3634,1302,28732,82.82,12.65,4.53
0662,2013,23616,3645,1452,28713,82.25,12.69,5.06
0662,2014,23476,3677,1584,28737,81.69,12.80,5.51
0662,2015,23361,3732,2179,29272,79.81,12.75,7.44
0662,2016,23060,3756,2662,29478,78.23,12.74,9.03
0662,2017,22897,3832,2900,29629,77.28,12.93,9.79
0662,2018,22752,3931,3174,29857,76.20,13.17,10.63
0662,2019,22672,3994,3297,29963,75.67,13.33,11.00
0662,2020,22384,3946,3305,29635,75.53,13.32,11.15
0662,2021,22239,3970,3347,29556,75.24,13.43,11.32
0662,2022,22049,4050,3382,29481,74.79,13.74,11.47
0662,2023,21673,4010,3331,29014,74.70,13.82,11.48
0665,2010,11295,1150,546,12991,86.94,8.85,4.20
0665,2011,11409,1175,576,13160,86.69,8.93,4.38
0665,2012,11377,1180,591,13148,86.53,8.97,4.49
0665,2013,11399,1215,595,13209,86.30,9.20,4.50
0665,2014,11380,1223,626,13229,86.02,9.24,4.73
0665,2015,11429,1250,693,13372,85.47,9.35,5.18
0665,2016,11532,1269,843,13644,84.52,9.30,6.18
0665,2017,11617,1323,900,13840,83.94,9.56,6.50
0665,2018,11676,1371,933,13980,83.52,9.81,6.67
0665,2019,11828,1389,1058,14275,82.86,9.73,7.41
0665,2020,11971,1442,1119,14532,82.38,9.92,7.70
0665,2021,12170,1457,1119,14746,82.53,9.88,7.59
0665,2022,12184,1493,1177,14854,82.03,10.05,7.92
0665,2023,12121,1511,1179,14811,81.84,10.20,7.96
0680,2010,109929,8320,9133,127382,86.30,6.53,7.17
0680,2011,110660,8304,9341,128305,86.25,6.47,7.28
0680,2012,111425,8378,9675,129478,86.06,6.47,7.47
0680,2013,111953,8615,10230,130798,85.59,6.59,7.82
0680,2014,112304,8763,11073,132140,84.99,6.63,8.38
0680,2015,112776,8877,11657,133310,84.60,6.66,8.74
0680,2016,113427,9110,12760,135297,83.84,6.73,9.43
0680,2017,114197,9329,13955,137481,83.06,6.79,10.15
0680,2018,114599,9488,15135,139222,82.31,6.82,10.87
0680,2019,115104,9636,16341,141081,81.59,6.83,11.58
0680,2020,115741,9701,16985,142427,81.26,6.81,11.93
0680,2021,116060,9826,17693,143579,80.83,6.84,12.32
0680,2022,116463,10046,18605,145114,80.26,6.92,12.82
0680,2023,116944,10215,19002,146161,80.01,6.99,13.00
0682,2010,26120,1666,1553,29339,89.03,5.68,5.29
0682,2011,25998,1708,1661,29367,88.53,5.82,5.66
0682,2012,25851,1727,1804,29382,87.98,5.88,6.14
0682,2013,25669,1743,2104,29516,86.97,5.91,7.13
0682,2014,25541,1791,2575,29907,85.40,5.99,8.61
0682,2015,25533,1815,3103,30451,83.85,5.96,10.19
0682,2016,25495,1837,3488,30820,82.72,5.96,11.32
0682,2017,25492,1925,3761,31178,81.76,6.17,12.06
0682,2018,25495,2040,3942,31477,81.00,6.48,12.52
0682,2019,25456,2076,4006,31538,80.72,6.58,12.70
0682,2020,25438,2080,4045,31563,80.59,6.59,12.82
0682,2021,25497,2123,4162,31782,80.22,6.68,13.10
0682,2022,25517,2195,4232,31944,79.88,6.87,13.25
0682,2023,25245,2243,4160,31648,79.77,7.09,13.14
0683,2010,27667,3785,1381,32833,84.27,11.53,4.21
0683,2011,27714,3780,1440,32934,84.15,11.48,4.37
0683,2012,27659,3801,1552,33012,83.78,11.51,4.70
0683,2013,27628,3818,1709,33155,83.33,11.52,5.15
0683,2014,27592,3844,1898,33334,82.77,11.53,5.69
0683,2015,27569,3833,2071,33473,82.36,11.45,6.19
0683,2016,27597,3889,2420,33906,81.39,11.47,7.14
0683,2017,27635,3965,2606,34206,80.79,11.59,7.62
0683,2018,27625,4000,2803,34428,80.24,11.62,8.14
0683,2019,27585,4007,2968,34560,79.82,11.59,8.59
0683,2020,27523,3986,3021,34530,79.71,11.54,8.75
0683,2021,27540,3980,3141,34661,79.46,11.48,9.06
0683,2022,27505,3993,3194,34692,79.28,11.51,9.21
0683,2023,27396,4073,3132,34601,79.18,11.77,9.05
0684,2010,9679,736,415,10830,89.37,6.80,3.83
0684,2011,9661,736,474,10871,88.87,6.77,4.36
0684,2012,9557,751,536,10844,88.13,6.93,4.94
0684,2013,9516,757,696,10969,86.75,6.90,6.35
0684,2014,9393,761,946,11100,84.62,6.86,8.52
0684,2015,9392,797,1039,11228,83.65,7.10,9.25
0684,2016,9386,849,1161,11396,82.36,7.45,10.19
0684,2017,9331,867,1298,11496,81.17,7.54,11.29
0684,2018,9372,878,1381,11631,80.58,7.55,11.87
0684,2019,9396,887,1394,11677,80.47,7.60,11.94
0684,2020,9442,862,1417,11721,80.56,7.35,12.09
0684,2021,9398,888,1423,11709,80.26,7.58,12.15
0684,2022,9394,908,1469,11771,79.81,7.71,12.48
0684,2023,9351,889,1428,11668,80.14,7.62,12.24
0685,2010,23671,1824,809,26304,89.99,6.93,3.08
0685,2011,23603,1823,876,26302,89.74,6.93,3.33
0685,2012,23538,1819,940,26297,89.51,6.92,3.57
0685,2013,23459,1856,1104,26419,88.80,7.03,4.18
0685,2014,23383,1936,1328,26647,87.75,7.27,4.98
0685,2015,23342,1969,1562,26873,86.86,7.33,5.81
0685,2016,23342,1994,1905,27241,85.69,7.32,6.99
0685,2017,23263,2016,2136,27415,84.86,7.35,7.79
0685,2018,23217,2026,2261,27504,84.41,7.37,8.22
0685,2019,23132,2019,2315,27466,84.22,7.35,8.43
0685,2020,23086,2016,2400,27502,83.94,7.33,8.73
0685,2021,23070,2049,2502,27621,83.52,7.42,9.06
0685,2022,23015,2149,2509,27673,83.17,7.77,9.07
0685,2023,22850,2167,2481,27498,83.10,7.88,9.02
0686,2010,14926,949,369,16244,91.89,5.84,2.27
0686,2011,14910,957,437,16304,91.45,5.87,2.68
0686,2012,14855,1011,502,16368,90.76,6.18,3.07
0686,2013,14846,1035,583,16464,90.17,6.29,3.54
0686,2014,14866,1068,664,16598,89.57,6.43,4.00
0686,2015,14881,1062,847,16790,88.63,6.33,5.04
0686,2016,14854,1078,1197,17129,86.72,6.29,6.99
0686,2017,14808,1115,1493,17416,85.03,6.40,8.57
0686,2018,14912,1174,1581,17667,84.41,6.65,8.95
0686,2019,14968,1151,1634,17753,84.31,6.48,9.20
0686,2020,14989,1165,1634,17788,84.26,6.55,9.19
0686,2021,15026,1169,1639,17834,84.25,6.55,9.19
0686,2022,15017,1202,1639,17858,84.09,6.73,9.18
0686,2023,14990,1222,1538,17750,84.45,6.88,8.66
0687,2010,16387,1037,695,18119,90.44,5.72,3.84
0687,2011,16355,1005,748,18108,90.32,5.55,4.13
0687,2012,16396,1000,749,18145,90.36,5.51,4.13
0687,2013,16311,1056,830,18197,89.64,5.80,4.56
0687,2014,16327,1100,989,18416,88.66,5.97,5.37
0687,2015,16275,1159,1112,18546,87.75,6.25,6.00
0687,2016,16257,1206,1331,18794,86.50,6.42,7.08
0687,2017,16128,1216,1550,18894,85.36,6.44,8.20
0687,2018,16007,1301,1679,18987,84.31,6.85,8.84
0687,2019,15924,1284,1795,19003,83.80,6.76,9.45
0687,2020,15807,1263,1833,18903,83.62,6.68,9.70
0687,2021,15809,1261,1804,18874,83.76,6.68,9.56
0687,2022,15732,1254,1818,18804,83.66,6.67,9.67
0687,2023,15681,1235,1839,18755,83.61,6.58,9.81
0760,2010,7974,943,327,9244,86.26,10.20,3.54
0760,2011,7850,970,396,9216,85.18,10.53,4.30
0760,2012,7750,1005,521,9276,83.55,10.83,5.62
0760,2013,7665,1015,608,9288,82.53,10.93,6.55
0760,2014,7608,995,619,9222,82.50,10.79,6.71
0760,2015,7586,1013,720,9319,81.40,10.87,7.73
0760,2016,7614,1025,869,9508,80.08,10.78,9.14
0760,2017,7528,1071,962,9561,78.74,11.20,10.06
0760,2018,7460,1090,1031,9581,77.86,11.38,10.76
0760,2019,7416,1082,1090,9588,77.35,11.28,11.37
0760,2020,7346,1076,1076,9498,77.34,11.33,11.33
0760,2021,7277,1096,1076,9449,77.01,11.60,11.39
0760,2022,7254,1105,1059,9418,77.02,11.73,11.24
0760,2023,7176,1117,970,9263,77.47,12.06,10.47
0761,2010,6920,732,487,8139,85.02,8.99,5.98
0761,2011,6873,742,462,8077,85.09,9.19,5.72
0761,2012,6781,734,497,8012,84.64,9.16,6.20
0761,2013,6639,759,661,8059,82.38,9.42,8.20
0761,2014,6517,770,969,8256,78.94,9.33,11.74
0761,2015,6455,768,1293,8516,75.80,9.02,15.18
0761,2016,6500,758,1502,8760,74.20,8.65,17.15
0761,2017,6485,761,1560,8806,73.64,8.64,17.72
0761,2018,6402,759,1619,8780,72.92,8.64,18.44
0761,2019,6415,758,1560,8733,73.46,8.68,17.86
0761,2020,6414,751,1490,8655,74.11,8.68,17.22
0761,2021,6378,756,1440,8574,74.39,8.82,16.79
0761,2022,6350,785,1350,8485,74.84,9.25,15.91
0761,2023,6293,796,1253,8342,75.44,9.54,15.02
0763,2010,10996,933,302,12231,89.90,7.63,2.47
0763,2011,10969,932,334,12235,89.65,7.62,2.73
0763,2012,10855,930,356,12141,89.41,7.66,2.93
0763,2013,10731,977,448,12156,88.28,8.04,3.69
0763,2014,10618,971,609,12198,87.05,7.96,4.99
0763,2015,10494,994,772,12260,85.60,8.11,6.30
0763,2016,10457,1014,922,12393,84.38,8.18,7.44
0763,2017,10468,1017,966,12451,84.07,8.17,7.76
0763,2018,10398,1032,977,12407,83.81,8.32,7.87
0763,2019,10344,1056,993,12393,83.47,8.52,8.01
0763,2020,10287,1059,1023,12369,83.17,8.56,8.27
0763,2021,10248,1114,957,12319,83.19,9.04,7.77
0763,2022,10144,1195,958,12297,82.49,9.72,7.79
0763,2023,10026,1204,925,12155,82.48,9.91,7.61
0764,2010,16380,1791,631,18802,87.12,9.53,3.36
0764,2011,16336,1850,731,18917,86.36,9.78,3.86
0764,2012,16245,1913,876,19034,85.35,10.05,4.60
0764,2013,16198,1911,1171,19280,84.01,9.91,6.07
0764,2014,16168,1941,1394,19503,82.90,9.95,7.15
0764,2015,16066,1961,1554,19581,82.05,10.01,7.94
0764,2016,16139,1953,1758,19850,81.30,9.84,8.86
0764,2017,16178,2052,1796,20026,80.78,10.25,8.97
0764,2018,16154,2072,1924,20150,80.17,10.28,9.55
0764,2019,16072,2089,1973,20134,79.83,10.38,9.80
0764,2020,16135,2095,1994,20224,79.78,10.36,9.86
0764,2021,16185,2087,2015,20287,79.78,10.29,9.93
0764,2022,16132,2111,2014,20257,79.64,10.42,9.94
0764,2023,15965,2116,1959,20040,79.67,10.56,9.78
0765,2010,13437,1394,772,15603,86.12,8.93,4.95
0765,2011,13362,1434,833,15629,85.49,9.18,5.33
0765,2012,13334,1474,916,15724,84.80,9.37,5.83
0765,2013,13285,1497,977,15759,84.30,9.50,6.20
0765,2014,13230,1555,1123,15908,83.17,9.77,7.06
0765,2015,13183,1665,1320,16168,81.54,10.30,8.16
0765,2016,13191,1719,1708,16618,79.38,10.34,10.28
0765,2017,13135,1809,2204,17148,76.60,10.55,12.85
0765,2018,13150,1920,2498,17568,74.85,10.93,14.22
0765,2019,13081,1893,2677,17651,74.11,10.72,15.17
0765,2020,13141,1971,2772,17884,73.48,11.02,15.50
0765,2021,13168,2035,2760,17963,73.31,11.33,15.36
0765,2022,13113,2175,2804,18092,72.48,12.02,15.50
0765,2023,13074,2161,2697,17932,72.91,12.05,15.04
0767,2010,8074,1281,264,9619,83.94,13.32,2.74
0767,2011,7970,1275,268,9513,83.78,13.40,2.82
0767,2012,7887,1300,290,9477,83.22,13.72,3.06
0767,2013,7848,1329,338,9515,82.48,13.97,3.55
0767,2014,7811,1343,395,9549,81.80,14.06,4.14
0767,2015,7804,1377,598,9779,79.80,14.08,6.12
0767,2016,7773,1378,840,9991,77.80,13.79,8.41
0767,2017,7786,1366,1018,10170,76.56,13.43,10.01
0767,2018,7780,1357,1123,10260,75.83,13.23,10.95
0767,2019,7783,1363,1174,10320,75.42,13.21,11.38
0767,2020,7797,1391,1185,10373,75.17,13.41,11.42
0767,2021,7757,1398,1165,10320,75.16,13.55,11.29
0767,2022,7663,1415,1088,10166,75.38,13.92,10.70
0767,2023,7599,1405,1072,10076,75.42,13.94,10.64
0780,2010,70753,6044,6208,83005,85.24,7.28,7.48
0780,2011,71135,6114,6461,83710,84.98,7.30,7.72
0780,2012,71948,6188,6664,84800,84.84,7.30,7.86
0780,2013,72271,6301,7250,85822,84.21,7.34,8.45
0780,2014,72780,6435,7755,86970,83.68,7.40,8.92
0780,2015,73403,6561,8144,88108,83.31,7.45,9.24
0780,2016,73908,6747,8845,89500,82.58,7.54,9.88
0780,2017,74601,6817,9642,91060,81.93,7.49,10.59
0780,2018,75286,7026,10255,92567,81.33,7.59,11.08
0780,2019,76062,7214,10853,94129,80.81,7.66,11.53
0780,2020,76516,7284,11059,94859,80.66,7.68,11.66
0780,2021,77040,7400,11555,95995,80.25,7.71,12.04
0780,2022,77535,7667,11935,97137,79.82,7.89,12.29
0780,2023,77901,7797,11876,97574,79.84,7.99,12.17
0781,2010,23730,2806,761,27297,86.93,10.28,2.79
0781,2011,23674,2895,788,27357,86.54,10.58,2.88
0781,2012,23519,3052,852,27423,85.76,11.13,3.11
0781,2013,23293,3043,941,27277,85.39,11.16,3.45
0781,2014,23287,3128,1107,27522,84.61,11.37,4.02
0781,2015,23193,3166,1279,27638,83.92,11.46,4.63
0781,2016,23176,3251,1581,28008,82.75,11.61,5.64
0781,2017,23118,3384,1795,28297,81.70,11.96,6.34
0781,2018,23150,3491,1932,28573,81.02,12.22,6.76
0781,2019,23018,3530,1973,28521,80.71,12.38,6.92
0781,2020,22907,3499,1995,28401,80.66,12.32,7.02
0781,2021,22885,3509,2039,28433,80.49,12.34,7.17
0781,2022,22765,3618,2100,28483,79.92,12.70,7.37
0781,2023,22599,3614,2091,28304,79.84,12.77,7.39
0821,2010,5024,558,195,5777,86.97,9.66,3.38
0821,2011,4975,582,211,5768,86.25,10.09,3.66
0821,2012,4938,558,234,5730,86.18,9.74,4.08
0821,2013,4863,554,301,5718,85.05,9.69,5.26
0821,2014,4790,551,441,5782,82.84,9.53,7.63
0821,2015,4688,550,619,5857,80.04,9.39,10.57
0821,2016,4631,577,872,6080,76.17,9.49,14.34
0821,2017,4574,584,929,6087,75.14,9.59,15.26
0821,2018,4542,599,953,6094,74.53,9.83,15.64
0821,2019,4454,579,888,5921,75.22,9.78,15.00
0821,2020,4366,598,767,5731,76.18,10.43,13.38
0821,2021,4295,650,700,5645,76.09,11.51,12.40
0821,2022,4213,733,638,5584,75.45,13.13,11.43
0821,2023,4088,768,582,5438,75.17,14.12,10.70
0834,2010,6426,354,182,6962,92.30,5.08,2.61
0834,2011,6368,350,168,6886,92.48,5.08,2.44
0834,2012,6336,363,159,6858,92.39,5.29,2.32
0834,2013,6321,372,186,6879,91.89,5.41,2.70
0834,2014,6318,389,218,6925,91.23,5.62,3.15
0834,2015,6257,396,290,6943,90.12,5.70,4.18
0834,2016,6206,435,422,7063,87.87,6.16,5.97
0834,2017,6248,425,410,7083,88.21,6.00,5.79
0834,2018,6235,436,427,7098,87.84,6.14,6.02
0834,2019,6273,440,412,7125,88.04,6.18,5.78
0834,2020,6318,440,391,7149,88.38,6.15,5.47
0834,2021,6301,445,367,7113,88.58,6.26,5.16
0834,2022,6220,486,336,7042,88.33,6.90,4.77
0834,2023,6207,468,327,7002,88.65,6.68,4.67
0840,2010,13328,460,233,14021,95.06,3.28,1.66
0840,2011,13424,470,244,14138,94.95,3.32,1.73
0840,2012,13504,474,278,14256,94.73,3.32,1.95
0840,2013,13562,498,308,14368,94.39,3.47,2.14
0840,2014,13624,546,328,14498,93.97,3.77,2.26
0840,2015,13716,553,400,14669,93.50,3.77,2.73
0840,2016,13677,588,651,14916,91.69,3.94,4.36
0840,2017,13777,591,632,15000,91.85,3.94,4.21
0840,2018,13778,618,652,15048,91.56,4.11,4.33
0840,2019,13962,627,660,15249,91.56,4.11,4.33
0840,2020,14174,645,668,15487,91.52,4.16,4.31
0840,2021,14379,671,672,15722,91.46,4.27,4.27
0840,2022,14625,675,685,15985,91.49,4.22,4.29
0840,2023,14783,702,659,16144,91.57,4.35,4.08
0860,2010,12149,1171,376,13696,88.70,8.55,2.75
0860,2011,11886,1227,402,13515,87.95,9.08,2.97
0860,2012,11827,1233,490,13550,87.28,9.10,3.62
0860,2013,11725,1241,669,13635,85.99,9.10,4.91
0860,2014,11640,1242,856,13738,84.73,9.04,6.23
0860,2015,11502,1260,1157,13919,82.64,9.05,8.31
0860,2016,11442,1297,1868,14607,78.33,8.88,12.79
0860,2017,11411,1335,1833,14579,78.27,9.16,12.57
0860,2018,11300,1362,1698,14360,78.69,9.48,11.82
0860,2019,11227,1405,1592,14224,78.93,9.88,11.19
0860,2020,11224,1423,1460,14107,79.56,10.09,10.35
0860,2021,11156,1463,1437,14056,79.37,10.41,10.22
0860,2022,11044,1581,1439,14064,78.53,11.24,10.23
0860,2023,10877,1591,1415,13883,78.35,11.46,10.19
0861,2010,11928,708,273,12909,92.40,5.48,2.11
0861,2011,11838,700,315,12853,92.10,5.45,2.45
0861,2012,11750,706,343,12799,91.80,5.52,2.68
0861,2013,11725,729,495,12949,90.55,5.63,3.82
0861,2014,11671,764,622,13057,89.39,5.85,4.76
0861,2015,11616,796,732,13144,88.37,6.06,5.57
0861,2016,11583,822,990,13395,86.47,6.14,7.39
0861,2017,11578,827,1093,13498,85.78,6.13,8.10
0861,2018,11564,864,1137,13565,85.25,6.37,8.38
0861,2019,11433,869,1128,13430,85.13,6.47,8.40
0861,2020,11337,858,1069,13264,85.47,6.47,8.06
0861,2021,11418,860,980,13258,86.12,6.49,7.39
0861,2022,11428,891,957,13276,86.08,6.71,7.21
0861,2023,11350,880,904,13134,86.42,6.70,6.88
0862,2010,8104,829,254,9187,88.21,9.02,2.76
0862,2011,7953,817,269,9039,87.99,9.04,2.98
0862,2012,7898,831,262,8991,87.84,9.24,2.91
0862,2013,7820,851,293,8964,87.24,9.49,3.27
0862,2014,7765,880,364,9009,86.19,9.77,4.04
0862,2015,7761,873,456,9090,85.38,9.60,5.02
0862,2016,7732,917,699,9348,82.71,9.81,7.48
0862,2017,7641,937,790,9368,81.56,10.00,8.43
0862,2018,7566,963,871,9400,80.49,10.24,9.27
0862,2019,7517,965,963,9445,79.59,10.22,10.20
0862,2020,7432,957,971,9360,79.40,10.22,10.37
0862,2021,7390,969,970,9329,79.22,10.39,10.40
0862,2022,7366,1032,949,9347,78.81,11.04,10.15
0862,2023,7198,1000,858,9056,79.48,11.04,9.47
0880,2010,56691,3239,2885,62815,90.25,5.16,4.59
0880,2011,56726,3315,3014,63055,89.96,5.26,4.78
0880,2012,57095,3444,3132,63671,89.67,5.41,4.92
0880,2013,57083,3497,3307,63887,89.35,5.47,5.18
0880,2014,57478,3530,3668,64676,88.87,5.46,5.67
0880,2015,57934,3683,4087,65704,88.17,5.61,6.22
0880,2016,58241,3773,4557,66571,87.49,5.67,6.85
0880,2017,58566,3870,5015,67451,86.83,5.74,7.44
0880,2018,59020,3999,5491,68510,86.15,5.84,8.01
0880,2019,59443,4104,5920,69467,85.57,5.91,8.52
0880,2020,59910,4181,6238,70329,85.19,5.94,8.87
0880,2021,60535,4250,6543,71328,84.87,5.96,9.17
0880,2022,60804,4387,6827,72018,84.43,6.09,9.48
0880,2023,60874,4461,6969,72304,84.19,6.17,9.64
0881,2010,17642,1497,512,19651,89.78,7.62,2.61
0881,2011,17540,1534,562,19636,89.33,7.81,2.86
0881,2012,17381,1528,577,19486,89.20,7.84,2.96
0881,2013,17294,1533,662,19489,88.74,7.87,3.40
0881,2014,17104,1584,1026,19714,86.76,8.03,5.20
0881,2015,16913,1569,1272,19754,85.62,7.94,6.44
0881,2016,16762,1595,1954,20311,82.53,7.85,9.62
0881,2017,16749,1641,2016,20406,82.08,8.04,9.88
0881,2018,16661,1631,2058,20350,81.87,8.01,10.11
0881,2019,16600,1625,2093,20318,81.70,8.00,10.30
0881,2020,16560,1633,2080,20273,81.68,8.06,10.26
0881,2021,16501,1684,2099,20284,81.35,8.30,10.35
0881,2022,16440,1754,2109,20303,80.97,8.64,10.39
0881,2023,16273,1762,2110,20145,80.78,8.75,10.47
0882,2010,23728,1598,837,26163,90.69,6.11,3.20
0882,2011,23643,1615,908,26166,90.36,6.17,3.47
0882,2012,23522,1657,965,26144,89.97,6.34,3.69
0882,2013,23445,1735,1032,26212,89.44,6.62,3.94
0882,2014,23367,1742,1192,26301,88.84,6.62,4.53
0882,2015,23317,1710,1423,26450,88.16,6.47,5.38
0882,2016,23300,1758,1948,27006,86.28,6.51,7.21
0882,2017,23275,1759,1894,26928,86.43,6.53,7.03
0882,2018,23107,1731,2090,26928,85.81,6.43,7.76
0882,2019,23185,1760,2157,27102,85.55,6.49,7.96
0882,2020,23108,1781,2258,27147,85.12,6.56,8.32
0882,2021,23072,1816,2332,27220,84.76,6.67,8.57
0882,2022,22879,1838,2311,27028,84.65,6.80,8.55
0882,2023,22805,1829,2284,26918,84.72,6.79,8.49
0883,2010,33523,1832,851,36206,92.59,5.06,2.35
0883,2011,33278,1826,911,36015,92.40,5.07,2.53
0883,2012,33062,1846,984,35892,92.12,5.14,2.74
0883,2013,32805,1869,1193,35867,91.46,5.21,3.33
0883,2014,32728,1889,1303,35920,91.11,5.26,3.63
0883,2015,32585,1897,1567,36049,90.39,5.26,4.35
0883,2016,32466,1953,2019,36438,89.10,5.36,5.54
0883,2017,32456,1963,2132,36551,88.80,5.37,5.83
0883,2018,32462,2011,2207,36680,88.50,5.48,6.02
0883,2019,32450,2002,2227,36679,88.47,5.46,6.07
0883,2020,32444,2003,2208,36655,88.51,5.46,6.02
0883,2021,32489,2051,2207,36747,88.41,5.58,6.01
0883,2022,32273,2099,2278,36650,88.06,5.73,6.22
0883,2023,32084,2147,2203,36434,88.06,5.89,6.05
0884,2010,14364,667,442,15473,92.83,4.31,2.86
0884,2011,14250,673,474,15397,92.55,4.37,3.08
0884,2012,14188,692,523,15403,92.11,4.49,3.40
0884,2013,14028,685,574,15287,91.76,4.48,3.75
0884,2014,13963,687,647,15297,91.28,4.49,4.23
0884,2015,13922,689,808,15419,90.29,4.47,5.24
0884,2016,13873,689,1074,15636,88.72,4.41,6.87
0884,2017,13806,716,1206,15728,87.78,4.55,7.67
0884,2018,13724,714,1326,15764,87.06,4.53,8.41
0884,2019,13617,723,1307,15647,87.03,4.62,8.35
0884,2020,13652,730,1290,15672,87.11,4.66,8.23
0884,2021,13581,751,1246,15578,87.18,4.82,8.00
0884,2022,13546,780,1231,15557,87.07,5.01,7.91
0884,2023,13435,825,1201,15461,86.90,5.34,7.77
0885,2010,9999,473,204,10676,93.66,4.43,1.91
0885,2011,9956,466,200,10622,93.73,4.39,1.88
0885,2012,9943,481,344,10768,92.34,4.47,3.19
0885,2013,9887,467,265,10619,93.11,4.40,2.50
0885,2014,9829,479,373,10681,92.02,4.48,3.49
0885,2015,9755,498,428,10681,91.33,4.66,4.01
0885,2016,9718,531,681,10930,88.91,4.86,6.23
0885,2017,9709,548,600,10857,89.43,5.05,5.53
0885,2018,9699,562,612,10873,89.20,5.17,5.63
0885,2019,9672,578,589,10839,89.23,5.33,5.43
0885,2020,9703,568,565,10836,89.54,5.24,5.21
0885,2021,9752,590,553,10895,89.51,5.42,5.08
0885,2022,9740,580,537,10857,89.71,5.34,4.95
0885,2023,9671,574,503,10748,89.98,5.34,4.68
0980,2010,54565,1542,1162,57269,95.28,2.69,2.03
0980,2011,54539,1556,1213,57308,95.17,2.72,2.12
0980,2012,54396,1600,1245,57241,95.03,2.80,2.18
0980,2013,54231,1656,1274,57161,94.87,2.90,2.23
0980,2014,54218,1695,1342,57255,94.70,2.96,2.34
0980,2015,54131,1773,1487,57391,94.32,3.09,2.59
0980,2016,54263,1893,1847,58003,93.55,3.26,3.18
0980,2017,54541,1974,2080,58595,93.08,3.37,3.55
0980,2018,54794,2037,2418,59249,92.48,3.44,4.08
0980,2019,54982,2111,2593,59686,92.12,3.54,4.34
0980,2020,55287,2178,2659,60124,91.95,3.62,4.42
0980,2021,55920,2287,2794,61001,91.67,3.75,4.58
0980,2022,55905,2350,2918,61173,91.39,3.84,4.77
0980,2023,55696,2398,2935,61029,91.26,3.93,4.81
1060,2010,10590,2098,300,12988,81.54,16.15,2.31
1060,2011,10483,2083,310,12876,81.42,16.18,2.41
1060,2012,10403,2116,377,12896,80.67,16.41,2.92
1060,2013,10332,2134,436,12902,80.08,16.54,3.38
1060,2014,10270,2122,639,13031,78.81,16.28,4.90
1060,2015,10206,2109,855,13170,77.49,16.01,6.49
1060,2016,10166,2086,1165,13417,75.77,15.55,8.68
1060,2017,10166,2072,1244,13482,75.40,15.37,9.23
1060,2018,10127,2054,1335,13516,74.93,15.20,9.88
1060,2019,10058,2050,1318,13426,74.91,15.27,9.82
1060,2020,10017,2037,1257,13311,75.25,15.30,9.44
1060,2021,10018,2043,1202,13263,75.53,15.40,9.06
1060,2022,9959,2047,1153,13159,75.68,15.56,8.76
1060,2023,9857,2097,1107,13061,75.47,16.06,8.48
1080,2010,57181,3001,3850,64032,89.30,4.69,6.01
1080,2011,57244,3063,3908,64215,89.14,4.77,6.09
1080,2012,57215,3064,3412,63691,89.83,4.81,5.36
1080,2013,57253,3175,3484,63912,89.58,4.97,5.45
1080,2014,57287,3254,3807,64348,89.03,5.06,5.92
1080,2015,57525,3336,4519,65380,87.99,5.10,6.91
1080,2016,57743,3411,5108,66262,87.14,5.15,7.71
1080,2017,57823,3543,5300,66666,86.74,5.31,7.95
1080,2018,57829,3554,5292,66675,86.73,5.33,7.94
1080,2019,57624,3572,5426,66622,86.49,5.36,8.14
1080,2020,57612,3508,5395,66515,86.62,5.27,8.11
1080,2021,57690,3572,5446,66708,86.48,5.35,8.16
1080,2022,57596,3581,5505,66682,86.37,5.37,8.26
1080,2023,57583,3576,5261,66420,86.70,5.38,7.92
1081,2010,25241,1712,1301,28254,89.34,6.06,4.60
1081,2011,25055,1727,1128,27910,89.77,6.19,4.04
1081,2012,24885,1727,1176,27788,89.55,6.21,4.23
1081,2013,24772,1731,1368,27871,88.88,6.21,4.91
1081,2014,24733,1756,1732,28221,87.64,6.22,6.14
1081,2015,24591,1761,2345,28697,85.69,6.14,8.17
1081,2016,24497,1771,2939,29207,83.87,6.06,10.06
1081,2017,24452,1763,3353,29568,82.70,5.96,11.34
1081,2018,24370,1752,3573,29695,82.07,5.90,12.03
1081,2019,24270,1737,3626,29633,81.90,5.86,12.24
1081,2020,24210,1699,3463,29372,82.43,5.78,11.79
1081,2021,24218,1671,3311,29200,82.94,5.72,11.34
1081,2022,24119,1735,3315,29169,82.69,5.95,11.36
1081,2023,24031,1759,3231,29021,82.81,6.06,11.13
1082,2010,28369,1817,957,31143,91.09,5.83,3.07
1082,2011,28293,1855,1037,31185,90.73,5.95,3.33
1082,2012,28100,1879,1153,31132,90.26,6.04,3.70
1082,2013,28000,1939,1333,31272,89.54,6.20,4.26
1082,2014,28070,1962,1566,31598,88.83,6.21,4.96
1082,2015,28054,1959,1833,31846,88.09,6.15,5.76
1082,2016,27970,1980,2180,32130,87.05,6.16,6.78
1082,2017,27846,1998,2356,32200,86.48,6.20,7.32
1082,2018,27802,1978,2550,32330,85.99,6.12,7.89
1082,2019,27775,1965,2733,32473,85.53,6.05,8.42
1082,2020,27671,1990,2741,32402,85.40,6.14,8.46
1082,2021,27483,1981,2762,32226,85.28,6.15,8.57
1082,2022,27462,2015,2739,32216,85.24,6.25,8.50
1082,2023,27325,1998,2673,31996,85.40,6.24,8.35
1083,2010,15132,1330,348,16810,90.02,7.91,2.07
1083,2011,15117,1337,339,16793,90.02,7.96,2.02
1083,2012,15103,1367,338,16808,89.86,8.13,2.01
1083,2013,15069,1358,373,16800,89.70,8.08,2.22
1083,2014,15077,1358,524,16959,88.90,8.01,3.09
1083,2015,15150,1372,638,17160,88.29,8.00,3.72
1083,2016,15228,1378,831,17437,87.33,7.90,4.77
1083,2017,15216,1360,879,17455,87.17,7.79,5.04
1083,2018,15231,1324,913,17468,87.19,7.58,5.23
1083,2019,15248,1314,890,17452,87.37,7.53,5.10
1083,2020,15327,1296,833,17456,87.80,7.42,4.77
1083,2021,15422,1285,833,17540,87.92,7.33,4.75
1083,2022,15381,1279,854,17514,87.82,7.30,4.88
1083,2023,15352,1270,853,17475,87.85,7.27,4.88
1214,2010,11689,1181,372,13242,88.27,8.92,2.81
1214,2011,11658,1214,378,13250,87.98,9.16,2.85
1214,2012,11615,1249,411,13275,87.50,9.41,3.10
1214,2013,11550,1298,484,13332,86.63,9.74,3.63
1214,2014,11534,1345,581,13460,85.69,9.99,4.32
1214,2015,11559,1424,672,13655,84.65,10.43,4.92
1214,2016,11614,1473,832,13919,83.44,10.58,5.98
1214,2017,11645,1508,872,14025,83.03,10.75,6.22
1214,2018,11666,1554,903,14123,82.60,11.00,6.39
1214,2019,11689,1615,964,14268,81.92,11.32,6.76
1214,2020,11701,1642,933,14276,81.96,11.50,6.54
1214,2021,11827,1659,926,14412,82.06,11.51,6.43
1214,2022,11825,1713,928,14466,81.74,11.84,6.42
1214,2023,11868,1737,939,14544,81.60,11.94,6.46
1230,2010,19913,1655,691,22259,89.46,7.44,3.10
1230,2011,19911,1660,725,22296,89.30,7.45,3.25
1230,2012,20104,1656,774,22534,89.22,7.35,3.43
1230,2013,20168,1677,827,22672,88.96,7.40,3.65
1230,2014,20368,1742,884,22994,88.58,7.58,3.84
1230,2015,20429,1775,915,23119,88.36,7.68,3.96
1230,2016,20715,1852,1033,23600,87.78,7.85,4.38
1230,2017,21041,1898,1228,24167,87.07,7.85,5.08
1230,2018,21430,1949,1345,24724,86.68,7.88,5.44
1230,2019,21816,2096,1484,25396,85.90,8.25,5.84
1230,2020,22126,2202,1555,25883,85.48,8.51,6.01
1230,2021,22362,2235,1645,26242,85.21,8.52,6.27
1230,2022,22640,2309,1829,26778,84.55,8.62,6.83
1230,2023,22879,2403,1870,27152,84.26,8.85,6.89
1231,2010,12197,2761,1743,16701,73.03,16.53,10.44
1231,2011,12299,2745,1799,16843,73.02,16.30,10.68
1231,2012,12305,2842,1864,17011,72.34,16.71,10.96
1231,2013,12349,2863,1902,17114,72.16,16.73,11.11
1231,2014,12275,2974,1962,17211,71.32,17.28,11.40
1231,2015,12311,3044,2075,17430,70.63,17.46,11.90
1231,2016,12349,3091,2206,17646,69.98,17.52,12.50
1231,2017,12419,3158,2496,18073,68.72,17.47,13.81
1231,2018,12435,3305,2620,18360,67.73,18.00,14.27
1231,2019,12830,3400,2882,19112,67.13,17.79,15.08
1231,2020,12990,3431,2891,19312,67.26,17.77,14.97
1231,2021,13088,3640,3025,19753,66.26,18.43,15.31
1231,2022,13041,3739,3102,19882,65.59,18.81,15.60
1231,2023,12907,3781,3156,19844,65.04,19.05,15.90
1233,2010,30866,1881,556,33303,92.68,5.65,1.67
1233,2011,31002,1919,589,33510,92.52,5.73,1.76
1233,2012,31055,1964,596,33615,92.38,5.84,1.77
1233,2013,31199,1988,620,33807,92.29,5.88,1.83
1233,2014,31431,2017,662,34110,92.15,5.91,1.94
1233,2015,31860,2096,711,34667,91.90,6.05,2.05
1233,2016,32253,2195,809,35257,91.48,6.23,2.29
1233,2017,32540,2234,1016,35790,90.92,6.24,2.84
1233,2018,33065,2272,1162,36499,90.59,6.22,3.18
1233,2019,33242,2309,1077,36628,90.76,6.30,2.94
1233,2020,33517,2363,1035,36915,90.80,6.40,2.80
1233,2021,33962,2440,1050,37452,90.68,6.52,2.80
1233,2022,34231,2487,1103,37821,90.51,6.58,2.92
1233,2023,34165,2501,1072,37738,90.53,6.63,2.84
1256,2010,12442,831,317,13590,91.55,6.11,2.33
1256,2011,12417,837,349,13603,91.28,6.15,2.57
1256,2012,12340,864,416,13620,90.60,6.34,3.05
1256,2013,12198,866,623,13687,89.12,6.33,4.55
1256,2014,12126,889,849,13864,87.46,6.41,6.12
1256,2015,11994,906,1202,14102,85.05,6.42,8.52
1256,2016,11892,867,1647,14406,82.55,6.02,11.43
1256,2017,11907,893,1915,14715,80.92,6.07,13.01
1256,2018,11929,915,2071,14915,79.98,6.13,13.89
1256,2019,11992,920,2095,15007,79.91,6.13,13.96
1256,2020,12041,942,2034,15017,80.18,6.27,13.54
1256,2021,12022,953,1966,14941,80.46,6.38,13.16
1256,2022,11862,976,1739,14577,81.37,6.70,11.93
1256,2023,11728,962,1641,14331,81.84,6.71,11.45
1257,2010,8351,1086,194,9631,86.71,11.28,2.01
1257,2011,8356,1094,213,9663,86.47,11.32,2.20
1257,2012,8325,1089,241,9655,86.22,11.28,2.50
1257,2013,8294,1066,293,9653,85.92,11.04,3.04
1257,2014,8309,1101,323,9733,85.37,11.31,3.32
1257,2015,8323,1080,428,9831,84.66,10.99,4.35
1257,2016,8305,1091,562,9958,83.40,10.96,5.64
1257,2017,8343,1115,589,10047,83.04,11.10,5.86
1257,2018,8335,1171,668,10174,81.92,11.51,6.57
1257,2019,8355,1225,700,10280,81.27,11.92,6.81
1257,2020,8471,1221,759,10451,81.05,11.68,7.26
1257,2021,8526,1257,716,10499,81.21,11.97,6.82
1257,2022,8473,1304,678,10455,81.04,12.47,6.48
1257,2023,8455,1312,666,10433,81.04,12.58,6.38
1260,2010,11974,2261,606,14841,80.68,15.23,4.08
1260,2011,11956,2280,615,14851,80.51,15.35,4.14
1260,2012,11962,2265,639,14866,80.47,15.24,4.30
1260,2013,11929,2216,656,14801,80.60,14.97,4.43
1260,2014,11888,2233,773,14894,79.82,14.99,5.19
1260,2015,11808,2316,838,14962,78.92,15.48,5.60
1260,2016,11791,2369,1042,15202,77.56,15.58,6.85
1260,2017,11737,2422,1270,15429,76.07,15.70,8.23
1260,2018,11667,2437,1397,15501,75.27,15.72,9.01
1260,2019,11730,2512,1473,15715,74.64,15.98,9.37
1260,2020,11677,2549,1471,15697,74.39,16.24,9.37
1260,2021,11688,2566,1588,15842,73.78,16.20,10.02
1260,2022,11814,2638,1610,16062,73.55,16.42,10.02
1260,2023,11678,2637,1653,15968,73.13,16.51,10.35
1261,2010,26694,1711,608,29013,92.01,5.90,2.10
1261,2011,26886,1741,634,29261,91.88,5.95,2.17
1261,2012,26986,1779,662,29427,91.70,6.05,2.25
1261,2013,27139,1766,695,29600,91.69,5.97,2.35
1261,2014,27217,1815,776,29808,91.31,6.09,2.60
1261,2015,27397,1850,857,30104,91.01,6.15,2.85
1261,2016,27641,1890,1001,30532,90.53,6.19,3.28
1261,2017,27869,1931,1159,30959,90.02,6.24,3.74
1261,2018,28186,1988,1317,31491,89.50,6.31,4.18
1261,2019,28300,1984,1421,31705,89.26,6.26,4.48
1261,2020,28529,1998,1493,32020,89.10,6.24,4.66
1261,2021,28763,2013,1565,32341,88.94,6.22,4.84
1261,2022,28789,2054,1627,32470,88.66,6.33,5.01
1261,2023,28638,2131,1661,32430,88.31,6.57,5.12
1262,2010,19944,1066,549,21559,92.51,4.94,2.55
1262,2011,20358,1083,576,22017,92.46,4.92,2.62
1262,2012,20577,1107,614,22298,92.28,4.96,2.75
1262,2013,20738,1093,665,22496,92.19,4.86,2.96
1262,2014,21125,1129,692,22946,92.06,4.92,3.02
1262,2015,21446,1174,704,23324,91.95,5.03,3.02
1262,2016,21843,1210,834,23887,91.44,5.07,3.49
1262,2017,22041,1272,951,24264,90.84,5.24,3.92
1262,2018,22331,1311,1121,24763,90.18,5.29,4.53
1262,2019,22300,1366,1168,24834,89.80,5.50,4.70
1262,2020,22354,1355,1167,24876,89.86,5.45,4.69
1262,2021,22142,1328,1168,24638,89.87,5.39,4.74
1262,2022,22153,1342,1226,24721,89.61,5.43,4.96
1262,2023,22072,1377,1178,24627,89.63,5.59,4.78
1263,2010,18128,1274,420,19822,91.45,6.43,2.12
1263,2011,18103,1265,437,19805,91.41,6.39,2.21
1263,2012,18229,1271,471,19971,91.28,6.36,2.36
1263,2013,18301,1241,525,20067,91.20,6.18,2.62
1263,2014,18457,1241,550,20248,91.15,6.13,2.72
1263,2015,18594,1287,581,20462,90.87,6.29,2.84
1263,2016,18702,1349,720,20771,90.04,6.49,3.47
1263,2017,18831,1384,859,21074,89.36,6.57,4.08
1263,2018,19162,1466,948,21576,88.81,6.79,4.39
1263,2019,19658,1564,1007,22229,88.43,7.04,4.53
1263,2020,19968,1651,1046,22665,88.10,7.28,4.62
1263,2021,20397,1704,1121,23222,87.83,7.34,4.83
1263,2022,20414,1725,1149,23288,87.66,7.41,4.93
1263,2023,20524,1779,1167,23470,87.45,7.58,4.97
1264,2010,13489,1143,349,14981,90.04,7.63,2.33
1264,2011,13458,1135,353,14946,90.04,7.59,2.36
1264,2012,13446,1147,362,14955,89.91,7.67,2.42
1264,2013,13470,1164,391,15025,89.65,7.75,2.60
1264,2014,13546,1175,446,15167,89.31,7.75,2.94
1264,2015,13476,1174,499,15149,88.96,7.75,3.29
1264,2016,13549,1212,647,15408,87.93,7.87,4.20
1264,2017,13628,1216,798,15642,87.12,7.77,5.10
1264,2018,13674,1230,855,15759,86.77,7.81,5.43
1264,2019,13751,1254,884,15889,86.54,7.89,5.56
1264,2020,13872,1298,872,16042,86.47,8.09,5.44
1264,2021,14154,1378,887,16419,86.21,8.39,5.40
1264,2022,14372,1454,905,16731,85.90,8.69,5.41
1264,2023,14432,1508,921,16861,85.59,8.94,5.46
1265,2010,16599,1239,274,18112,91.65,6.84,1.51
1265,2011,16590,1256,297,18143,91.44,6.92,1.64
1265,2012,16704,1264,322,18290,91.33,6.91,1.76
1265,2013,16745,1317,339,18401,91.00,7.16,1.84
1265,2014,16680,1329,406,18415,90.58,7.22,2.20
1265,2015,16739,1360,415,18514,90.41,7.35,2.24
1265,2016,16873,1388,481,18742,90.03,7.41,2.57
1265,2017,17083,1405,583,19071,89.58,7.37,3.06
1265,2018,17112,1433,608,19153,89.34,7.48,3.17
1265,2019,17160,1444,622,19226,89.25,7.51,3.24
1265,2020,17290,1494,628,19412,89.07,7.70,3.24
1265,2021,17342,1542,613,19497,88.95,7.91,3.14
1265,2022,17331,1589,627,19547,88.66,8.13,3.21
1265,2023,17197,1599,641,19437,88.48,8.23,3.30
1266,2010,13340,1095,405,14840,89.89,7.38,2.73
1266,2011,13376,1094,431,14901,89.77,7.34,2.89
1266,2012,13368,1115,475,14958,89.37,7.45,3.18
1266,2013,13314,1119,484,14917,89.25,7.50,3.24
1266,2014,13258,1161,508,14927,88.82,7.78,3.40
1266,2015,13297,1169,554,15020,88.53,7.78,3.69
1266,2016,13435,1221,627,15283,87.91,7.99,4.10
1266,2017,13556,1247,749,15552,87.17,8.02,4.82
1266,2018,13624,1264,747,15635,87.14,8.08,4.78
1266,2019,13645,1229,757,15631,87.29,7.86,4.84
1266,2020,13721,1237,695,15653,87.66,7.90,4.44
1266,2021,13816,1259,670,15745,87.75,8.00,4.26
1266,2022,13767,1310,641,15718,87.59,8.33,4.08
1266,2023,13631,1307,647,15585,87.46,8.39,4.15
1267,2010,13864,1251,345,15460,89.68,8.09,2.23
1267,2011,13870,1249,373,15492,89.53,8.06,2.41
1267,2012,13875,1269,382,15526,89.37,8.17,2.46
1267,2013,13992,1265,380,15637,89.48,8.09,2.43
1267,2014,14097,1276,397,15770,89.39,8.09,2.52
1267,2015,14261,1284,425,15970,89.30,8.04,2.66
1267,2016,14375,1314,503,16192,88.78,8.12,3.11
1267,2017,14544,1317,617,16478,88.26,7.99,3.74
1267,2018,14620,1358,659,16637,87.88,8.16,3.96
1267,2019,14684,1355,674,16713,87.86,8.11,4.03
1267,2020,14787,1386,657,16830,87.86,8.24,3.90
1267,2021,14931,1383,640,16954,88.07,8.16,3.77
1267,2022,15193,1457,647,17297,87.84,8.42,3.74
1267,2023,15296,1422,658,17376,88.03,8.18,3.79
1270,2010,11803,905,206,12914,91.40,7.01,1.60
1270,2011,11794,924,212,12930,91.21,7.15,1.64
1270,2012,11721,935,261,12917,90.74,7.24,2.02
1270,2013,11674,932,285,12891,90.56,7.23,2.21
1270,2014,11732,943,332,13007,90.20,7.25,2.55
1270,2015,11737,953,442,13132,89.38,7.26,3.37
1270,2016,11787,971,572,13330,88.42,7.28,4.29
1270,2017,11791,974,651,13416,87.89,7.26,4.85
1270,2018,11831,990,736,13557,87.27,7.30,5.43
1270,2019,11826,1007,784,13617,86.85,7.40,5.76
1270,2020,11909,995,759,13663,87.16,7.28,5.56
1270,2021,11912,1003,797,13712,86.87,7.31,5.81
1270,2022,11980,1028,804,13812,86.74,7.44,5.82
1270,2023,11794,1068,798,13660,86.34,7.82,5.84
1272,2010,10992,981,299,12272,89.57,7.99,2.44
1272,2011,10984,1021,361,12366,88.82,8.26,2.92
1272,2012,10839,1015,396,12250,88.48,8.29,3.23
1272,2013,10858,1011,467,12336,88.02,8.20,3.79
1272,2014,10823,1011,566,12400,87.28,8.15,4.56
1272,2015,10818,1011,684,12513,86.45,8.08,5.47
1272,2016,10808,1026,791,12625,85.61,8.13,6.27
1272,2017,10766,1030,903,12699,84.78,8.11,7.11
1272,2018,10757,1070,1049,12876,83.54,8.31,8.15
1272,2019,10722,1078,1070,12870,83.31,8.38,8.31
1272,2020,10594,1100,1065,12759,83.03,8.62,8.35
1272,2021,10473,1095,1082,12650,82.79,8.66,8.55
1272,2022,10471,1112,1050,12633,82.89,8.80,8.31
1272,2023,10402,1093,1003,12498,83.23,8.75,8.03
1273,2010,11295,965,464,12724,88.77,7.58,3.65
1273,2011,11182,997,520,12699,88.05,7.85,4.09
1273,2012,11099,992,546,12637,87.83,7.85,4.32
1273,2013,11141,1016,556,12713,87.63,7.99,4.37
1273,2014,11143,1002,683,12828,86.86,7.81,5.32
1273,2015,11135,1016,803,12954,85.96,7.84,6.20
1273,2016,11104,1026,1019,13149,84.45,7.80,7.75
1273,2017,10999,1055,1128,13182,83.44,8.00,8.56
1273,2018,10982,1076,1209,13267,82.78,8.11,9.11
1273,2019,10932,1098,1178,13208,82.77,8.31,8.92
1273,2020,10928,1104,1166,13198,82.80,8.36,8.83
1273,2021,10938,1158,1173,13269,82.43,8.73,8.84
1273,2022,10880,1177,1181,13238,82.19,8.89,8.92
1273,2023,10754,1186,1166,13106,82.05,9.05,8.90
1275,2010,5735,828,498,7061,81.22,11.73,7.05
1275,2011,5807,810,542,7159,81.11,11.31,7.57
1275,2012,5785,821,490,7096,81.52,11.57,6.91
1275,2013,5764,840,535,7139,80.74,11.77,7.49
1275,2014,5743,824,607,7174,80.05,11.49,8.46
1275,2015,5723,841,647,7211,79.36,11.66,8.97
1275,2016,5647,840,851,7338,76.96,11.45,11.60
1275,2017,5627,847,861,7335,76.71,11.55,11.74
1275,2018,5593,891,995,7479,74.78,11.91,13.30
1275,2019,5564,874,1054,7492,74.27,11.67,14.07
1275,2020,5530,875,1071,7476,73.97,11.70,14.33
1275,2021,5538,888,1139,7565,73.21,11.74,15.06
1275,2022,5488,859,1095,7442,73.74,11.54,14.71
1275,2023,5414,888,1021,7323,73.93,12.13,13.94
1276,2010,14300,1884,331,16515,86.59,11.41,2.00
1276,2011,14358,1894,349,16601,86.49,11.41,2.10
1276,2012,14430,1859,371,16660,86.61,11.16,2.23
1276,2013,14440,1899,376,16715,86.39,11.36,2.25
1276,2014,14355,1947,431,16733,85.79,11.64,2.58
1276,2015,14392,2006,519,16917,85.07,11.86,3.07
1276,2016,14386,2129,704,17219,83.55,12.36,4.09
1276,2017,14427,2160,875,17462,82.62,12.37,5.01
1276,2018,14378,2206,1016,17600,81.69,12.53,5.77
1276,2019,14428,2284,1044,17756,81.26,12.86,5.88
1276,2020,14412,2328,998,17738,81.25,13.12,5.63
1276,2021,14440,2341,1002,17783,81.20,13.16,5.63
1276,2022,14391,2417,1057,17865,80.55,13.53,5.92
1276,2023,14334,2370,1019,17723,80.88,13.37,5.75
1277,2010,11904,2061,772,14737,80.78,13.99,5.24
1277,2011,11941,2067,781,14789,80.74,13.98,5.28
1277,2012,11858,2135,813,14806,80.09,14.42,5.49
1277,2013,11876,2182,869,14927,79.56,14.62,5.82
1277,2014,11826,2235,1000,15061,78.52,14.84,6.64
1277,2015,11746,2231,1216,15193,77.31,14.68,8.00
1277,2016,11746,2291,1491,15528,75.64,14.75,9.60
1277,2017,11783,2303,1742,15828,74.44,14.55,11.01
1277,2018,11888,2360,1739,15987,74.36,14.76,10.88
1277,2019,11825,2391,1724,15940,74.18,15.00,10.82
1277,2020,11809,2448,1806,16063,73.52,15.24,11.24
1277,2021,11879,2577,1852,16308,72.84,15.80,11.36
1277,2022,11766,2679,1896,16341,72.00,16.39,11.60
1277,2023,11790,2753,1915,16458,71.64,16.73,11.64
1278,2010,12931,983,364,14278,90.57,6.88,2.55
1278,2011,12866,985,379,14230,90.41,6.92,2.66
1278,2012,12823,1036,404,14263,89.90,7.26,2.83
1278,2013,12794,1052,429,14275,89.63,7.37,3.01
1278,2014,12835,1103,481,14419,89.01,7.65,3.34
1278,2015,12708,1093,572,14373,88.42,7.60,3.98
1278,2016,12769,1115,730,14614,87.38,7.63,5.00
1278,2017,12816,1147,833,14796,86.62,7.75,5.63
1278,2018,12919,1175,854,14948,86.43,7.86,5.71
1278,2019,13068,1178,882,15128,86.38,7.79,5.83
1278,2020,13306,1230,877,15413,86.33,7.98,5.69
1278,2021,13500,1293,843,15636,86.34,8.27,5.39
1278,2022,13629,1329,866,15824,86.13,8.40,5.47
1278,2023,13757,1351,804,15912,86.46,8.49,5.05
1280,2010,208614,51185,39164,298963,69.78,17.12,13.10
1280,2011,210607,51383,40845,302835,69.55,16.97,13.49
1280,2012,213015,51996,42747,307758,69.22,16.90,13.89
1280,2013,215674,52511,44809,312994,68.91,16.78,14.32
1280,2014,218319,52973,46815,318107,68.63,16.65,14.72
1280,2015,220527,53401,48646,322574,68.36,16.55,15.08
1280,2016,222272,53810,52412,328494,67.66,16.38,15.96
1280,2017,223169,54478,55986,333633,66.89,16.33,16.78
1280,2018,224541,55331,59441,339313,66.18,16.31,17.52
1280,2019,225843,56162,62161,344166,65.62,16.32,18.06
1280,2020,227432,56584,63933,347949,65.36,16.26,18.37
1280,2021,228459,57231,66059,351749,64.95,16.27,18.78
1280,2022,230255,58600,68522,357377,64.43,16.40,19.17
1280,2023,232205,59726,70202,362133,64.12,16.49,19.39
1281,2010,91259,9723,9506,110488,82.60,8.80,8.60
1281,2011,91985,9889,9792,111666,82.38,8.86,8.77
1281,2012,92709,10112,10129,112950,82.08,8.95,8.97
1281,2013,93386,10505,10400,114291,81.71,9.19,9.10
1281,2014,94198,10916,10854,115968,81.23,9.41,9.36
1281,2015,94891,11325,10618,116834,81.22,9.69,9.09
1281,2016,95378,11747,11417,118542,80.46,9.91,9.63
1281,2017,96177,12330,12767,121274,79.31,10.17,10.53
1281,2018,96312,12616,14020,122948,78.34,10.26,11.40
1281,2019,97099,12889,14947,124935,77.72,10.32,11.96
1281,2020,97573,12952,15416,125941,77.48,10.28,12.24
1281,2021,98078,13338,15960,127376,77.00,10.47,12.53
1281,2022,98199,13651,16534,128384,76.49,10.63,12.88
1281,2023,99385,14168,16735,130288,76.28,10.87,12.84
1282,2010,31633,7447,2644,41724,75.81,17.85,6.34
1282,2011,31999,7473,2717,42189,75.85,17.71,6.44
1282,2012,32210,7539,2811,42560,75.68,17.71,6.60
1282,2013,32365,7608,3100,43073,75.14,17.66,7.20
1282,2014,32473,7617,3484,43574,74.52,17.48,8.00
1282,2015,32535,7647,3779,43961,74.01,17.39,8.60
1282,2016,32800,7713,4098,44611,73.52,17.29,9.19
1282,2017,33046,7790,4450,45286,72.97,17.20,9.83
1282,2018,33355,7825,4595,45775,72.87,17.09,10.04
1282,2019,33543,7888,4659,46090,72.78,17.11,10.11
1282,2020,33766,7804,4735,46305,72.92,16.85,10.23
1282,2021,33915,7772,4801,46488,72.95,16.72,10.33
1282,2022,34102,7957,4945,47004,72.55,16.93,10.52
1282,2023,34168,7977,4989,47134,72.49,16.92,10.58
1283,2010,103924,15920,9333,129177,80.45,12.32,7.22
1283,2011,104640,16184,9802,130626,80.11,12.39,7.50
1283,2012,104987,16636,10388,132011,79.53,12.60,7.87
1283,2013,105265,16863,10861,132989,79.15,12.68,8.17
1283,2014,106050,17163,12131,135344,78.36,12.68,8.96
1283,2015,106745,17610,13554,137909,77.40,12.77,9.83
1283,2016,107408,17872,15267,140547,76.42,12.72,10.86
1283,2017,107867,18267,17170,143304,75.27,12.75,11.98
1283,2018,108127,18578,18710,145415,74.36,12.78,12.87
1283,2019,108779,18858,20097,147734,73.63,12.76,13.60
1283,2020,109242,18987,21051,149280,73.18,12.72,14.10
1283,2021,108977,19194,21938,150109,72.60,12.79,14.61
1283,2022,108604,19406,22965,150975,71.94,12.85,15.21
1283,2023,108366,19511,23429,151306,71.62,12.90,15.48
1284,2010,22117,1860,660,24637,89.77,7.55,2.68
1284,2011,22095,1926,677,24698,89.46,7.80,2.74
1284,2012,22196,1947,720,24863,89.27,7.83,2.90
1284,2013,22371,1978,735,25084,89.18,7.89,2.93
1284,2014,22452,2077,769,25298,88.75,8.21,3.04
1284,2015,22598,2155,857,25610,88.24,8.41,3.35
1284,2016,22593,2179,1075,25847,87.41,8.43,4.16
1284,2017,22779,2248,1166,26193,86.97,8.58,4.45
1284,2018,22997,2271,1298,26566,86.57,8.55,4.89
1284,2019,23203,2320,1419,26942,86.12,8.61,5.27
1284,2020,23412,2323,1433,27168,86.17,8.55,5.27
1284,2021,23706,2423,1460,27589,85.93,8.78,5.29
1284,2022,24121,2480,1502,28103,85.83,8.82,5.34
1284,2023,24206,2490,1497,28193,85.86,8.83,5.31
1285,2010,27154,3137,1296,31587,85.97,9.93,4.10
1285,2011,27165,3197,1366,31728,85.62,10.08,4.31
1285,2012,27146,3196,1402,31744,85.52,10.07,4.42
1285,2013,27269,3168,1483,31920,85.43,9.92,4.65
1285,2014,27294,3255,1630,32179,84.82,10.12,5.07
1285,2015,27356,3342,1740,32438,84.33,10.30,5.36
1285,2016,27403,3474,2001,32878,83.35,10.57,6.09
1285,2017,27360,3568,2308,33236,82.32,10.74,6.94
1285,2018,27359,3615,2583,33557,81.53,10.77,7.70
1285,2019,27343,3611,2839,33793,80.91,10.69,8.40
1285,2020,27392,3659,3072,34123,80.27,10.72,9.00
1285,2021,27503,3799,3291,34593,79.50,10.98,9.51
1285,2022,27423,3907,3371,34701,79.03,11.26,9.71
1285,2023,27400,4012,3363,34775,78.79,11.54,9.67
1286,2010,26082,1700,556,28338,92.04,6.00,1.96
1286,2011,26120,1725,582,28427,91.88,6.07,2.05
1286,2012,26192,1758,608,28558,91.72,6.16,2.13
1286,2013,26212,1777,634,28623,91.58,6.21,2.22
1286,2014,26285,1768,718,28771,91.36,6.15,2.50
1286,2015,26397,1751,837,28985,91.07,6.04,2.89
1286,2016,26518,1788,1142,29448,90.05,6.07,3.88
1286,2017,26812,1826,1210,29848,89.83,6.12,4.05
1286,2018,27010,1869,1347,30226,89.36,6.18,4.46
1286,2019,27264,1914,1363,30541,89.27,6.27,4.46
1286,2020,27607,1902,1461,30970,89.14,6.14,4.72
1286,2021,28074,1964,1522,31560,88.95,6.22,4.82
1286,2022,28163,1968,1583,31714,88.80,6.21,4.99
1286,2023,28325,1987,1599,31911,88.76,6.23,5.01
1287,2010,36219,4933,1067,42219,85.79,11.68,2.53
1287,2011,36396,4977,1169,42542,85.55,11.70,2.75
1287,2012,36402,4989,1214,42605,85.44,11.71,2.85
1287,2013,36483,5069,1285,42837,85.17,11.83,3.00
1287,2014,36407,5140,1426,42973,84.72,11.96,3.32
1287,2015,36573,5152,1634,43359,84.35,11.88,3.77
1287,2016,36867,5209,1837,43913,83.95,11.86,4.18
1287,2017,37110,5328,2157,44595,83.22,11.95,4.84
1287,2018,37191,5420,2291,44902,82.83,12.07,5.10
1287,2019,37510,5525,2405,45440,82.55,12.16,5.29
1287,2020,37801,5572,2504,45877,82.40,12.15,5.46
1287,2021,37978,5619,2634,46231,82.15,12.15,5.70
1287,2022,38082,5812,2755,46649,81.64,12.46,5.91
1287,2023,38163,5946,2827,46936,81.31,12.67,6.02
1290,2010,68620,5647,5276,79543,86.27,7.10,6.63
1290,2011,68636,5762,5532,79930,85.87,7.21,6.92
1290,2012,68745,5850,5912,80507,85.39,7.27,7.34
1290,2013,68671,5916,6422,81009,84.77,7.30,7.93
1290,2014,68752,6036,7038,81826,84.02,7.38,8.60
1290,2015,68837,6201,7472,82510,83.43,7.52,9.06
1290,2016,68872,6291,8028,83191,82.79,7.56,9.65
1290,2017,69038,6403,8710,84151,82.04,7.61,10.35
1290,2018,69302,6409,9197,84908,81.62,7.55,10.83
1290,2019,69472,6492,9783,85747,81.02,7.57,11.41
1290,2020,69484,6558,10175,86217,80.59,7.61,11.80
1290,2021,69620,6594,10427,86641,80.35,7.61,12.03
1290,2022,69514,6623,10601,86738,80.14,7.64,12.22
1290,2023,69292,6668,10600,86560,80.05,7.70,12.25
1291,2010,17665,1186,446,19297,91.54,6.15,2.31
1291,2011,17522,1187,438,19147,91.51,6.20,2.29
1291,2012,17318,1205,474,18997,91.16,6.34,2.50
1291,2013,17181,1218,552,18951,90.66,6.43,2.91
1291,2014,16978,1221,706,18905,89.81,6.46,3.73
1291,2015,16935,1231,899,19065,88.83,6.46,4.72
1291,2016,16933,1243,1309,19485,86.90,6.38,6.72
1291,2017,16833,1256,1287,19376,86.88,6.48,6.64
1291,2018,16739,1255,1284,19278,86.83,6.51,6.66
1291,2019,16650,1226,1298,19174,86.84,6.39,6.77
1291,2020,16738,1250,1239,19227,87.05,6.50,6.44
1291,2021,16774,1277,1216,19267,87.06,6.63,6.31
1291,2022,16608,1267,1199,19074,87.07,6.64,6.29
1291,2023,16533,1285,1144,18962,87.19,6.78,6.03
1292,2010,35736,2623,1035,39394,90.71,6.66,2.63
1292,2011,35826,2712,1088,39626,90.41,6.84,2.75
1292,2012,35830,2761,1151,39742,90.16,6.95,2.90
1292,2013,35808,2791,1267,39866,89.82,7.00,3.18
1292,2014,35995,2832,1402,40229,89.48,7.04,3.49
1292,2015,36326,2926,1480,40732,89.18,7.18,3.63
1292,2016,36650,2991,1695,41336,88.66,7.24,4.10
1292,2017,36744,3103,1939,41786,87.93,7.43,4.64
1292,2018,36906,3141,2084,42131,87.60,7.46,4.95
1292,2019,37101,3208,2167,42476,87.35,7.55,5.10
1292,2020,37443,3255,2212,42910,87.26,7.59,5.15
1292,2021,37961,3387,2285,43633,87.00,7.76,5.24
1292,2022,38440,3476,2352,44268,86.83,7.85,5.31
1292,2023,38842,3580,2444,44866,86.57,7.98,5.45
1293,2010,44249,3926,1932,50107,88.31,7.84,3.86
1293,2011,44140,3980,2044,50164,87.99,7.93,4.07
1293,2012,43998,4003,2162,50163,87.71,7.98,4.31
1293,2013,43834,4092,2301,50227,87.27,8.15,4.58
1293,2014,43756,4113,2696,50565,86.53,8.13,5.33
1293,2015,43836,4190,3022,51048,85.87,8.21,5.92
1293,2016,43753,4269,3645,51667,84.68,8.26,7.05
1293,2017,43694,4304,4005,52003,84.02,8.28,7.70
1293,2018,43535,4335,4251,52121,83.53,8.32,8.16
1293,2019,43418,4373,4354,52145,83.26,8.39,8.35
1293,2020,43261,4314,4435,52010,83.18,8.29,8.53
1293,2021,43384,4366,4559,52309,82.94,8.35,8.72
1293,2022,43290,4488,4591,52369,82.66,8.57,8.77
1293,2023,43122,4534,4585,52241,82.54,8.68,8.78
1315,2010,8586,1257,334,10177,84.37,12.35,3.28
1315,2011,8463,1285,378,10126,83.58,12.69,3.73
1315,2012,8351,1275,406,10032,83.24,12.71,4.05
1315,2013,8230,1268,503,10001,82.29,12.68,5.03
1315,2014,8240,1293,745,10278,80.17,12.58,7.25
1315,2015,8169,1298,1047,10514,77.70,12.35,9.96
1315,2016,8205,1305,1444,10954,74.90,11.91,13.18
1315,2017,8133,1342,1515,10990,74.00,12.21,13.79
1315,2018,8091,1320,1503,10914,74.13,12.09,13.77
1315,2019,8022,1307,1486,10815,74.17,12.09,13.74
1315,2020,7997,1291,1361,10649,75.10,12.12,12.78
1315,2021,8013,1326,1280,10619,75.46,12.49,12.05
1315,2022,7920,1311,1233,10464,75.69,12.53,11.78
1315,2023,7803,1331,1165,10299,75.76,12.92,11.31
1380,2010,78711,9105,3984,91800,85.74,9.92,4.34
1380,2011,79033,9226,4035,92294,85.63,10.00,4.37
1380,2012,79624,9362,4245,93231,85.41,10.04,4.55
1380,2013,80030,9476,4578,94084,85.06,10.07,4.87
1380,2014,80479,9690,5363,95532,84.24,10.14,5.61
1380,2015,80972,9861,6119,96952,83.52,10.17,6.31
1380,2016,81519,9921,7098,98538,82.73,10.07,7.20
1380,2017,81944,10063,7745,99752,82.15,10.09,7.76
1380,2018,82476,10239,8553,101268,81.44,10.11,8.45
1380,2019,83121,10327,9319,102767,80.88,10.05,9.07
1380,2020,83622,10363,9769,103754,80.60,9.99,9.42
1380,2021,83821,10463,10289,104573,80.16,10.01,9.84
1380,2022,83900,10532,10716,105148,79.79,10.02,10.19
1380,2023,84226,10547,11023,105796,79.61,9.97,10.42
1381,2010,21185,1780,425,23390,90.57,7.61,1.82
1381,2011,21227,1765,478,23470,90.44,7.52,2.04
1381,2012,21194,1729,535,23458,90.35,7.37,2.28
1381,2013,21204,1720,593,23517,90.16,7.31,2.52
1381,2014,21158,1777,846,23781,88.97,7.47,3.56
1381,2015,21209,1862,1124,24195,87.66,7.70,4.65
1381,2016,21322,1925,1417,24664,86.45,7.80,5.75
1381,2017,21488,2031,1628,25147,85.45,8.08,6.47
1381,2018,21689,2058,1744,25491,85.08,8.07,6.84
1381,2019,21924,2163,1816,25903,84.64,8.35,7.01
1381,2020,22012,2199,1756,25967,84.77,8.47,6.76
1381,2021,22344,2233,1742,26319,84.90,8.48,6.62
1381,2022,22503,2363,1709,26575,84.68,8.89,6.43
1381,2023,22532,2389,1644,26565,84.82,8.99,6.19
1382,2010,36651,2911,1446,41008,89.38,7.10,3.53
1382,2011,36852,2996,1456,41304,89.22,7.25,3.53
1382,2012,36904,3005,1514,41423,89.09,7.25,3.65
1382,2013,37057,3082,1773,41912,88.42,7.35,4.23
1382,2014,37343,3104,1986,42433,88.00,7.32,4.68
1382,2015,37506,3152,2291,42949,87.33,7.34,5.33
1382,2016,37739,3179,2949,43867,86.03,7.25,6.72
1382,2017,38008,3236,2951,44195,86.00,7.32,6.68
1382,2018,38279,3261,3161,44701,85.63,7.30,7.07
1382,2019,38631,3353,3383,45367,85.15,7.39,7.46
1382,2020,39073,3413,3565,46051,84.85,7.41,7.74
1382,2021,39612,3464,3697,46773,84.69,7.41,7.90
1382,2022,39847,3482,3688,47017,84.75,7.41,7.84
1382,2023,39902,3517,3689,47108,84.70,7.47,7.83
1383,2010,53143,3538,1403,58084,91.49,6.09,2.42
1383,2011,53529,3608,1439,58576,91.38,6.16,2.46
1383,2012,53987,3698,1501,59186,91.22,6.25,2.54
1383,2013,54475,3772,1689,59936,90.89,6.29,2.82
1383,2014,54813,3859,1750,60422,90.72,6.39,2.90
1383,2015,55180,3940,1910,61030,90.41,6.46,3.13
1383,2016,55635,3971,2262,61868,89.93,6.42,3.66
1383,2017,56192,4073,2490,62755,89.54,6.49,3.97
1383,2018,56757,4148,2725,63630,89.20,6.52,4.28
1383,2019,57368,4308,2925,64601,88.80,6.67,4.53
1383,2020,57989,4437,2971,65397,88.67,6.78,4.54
1383,2021,58981,4547,3130,66658,88.48,6.82,4.70
1383,2022,59896,4669,3235,67800,88.34,6.89,4.77
1383,2023,60317,4721,3287,68325,88.28,6.91,4.81
1384,2010,70278,3146,1601,75025,93.67,4.19,2.13
1384,2011,71024,3248,1682,75954,93.51,4.28,2.21
1384,2012,71699,3313,1774,76786,93.38,4.31,2.31
1384,2013,72102,3385,1903,77390,93.17,4.37,2.46
1384,2014,72771,3445,2003,78219,93.03,4.40,2.56
1384,2015,73439,3542,2163,79144,92.79,4.48,2.73
1384,2016,74364,3627,2451,80442,92.44,4.51,3.05
1384,2017,75247,3768,2971,81986,91.78,4.60,3.62
1384,2018,76048,3884,3416,83348,91.24,4.66,4.10
1384,2019,76743,3991,3661,84395,90.93,4.73,4.34
1384,2020,77155,4034,3741,84930,90.85,4.75,4.40
1384,2021,77397,4043,3861,85301,90.73,4.74,4.53
1384,2022,77616,4155,4030,85801,90.46,4.84,4.70
1384,2023,77477,4211,3965,85653,90.45,4.92,4.63
1401,2010,31105,2074,1284,34463,90.26,6.02,3.73
1401,2011,31450,2073,1331,34854,90.23,5.95,3.82
1401,2012,31775,2060,1388,35223,90.21,5.85,3.94
1401,2013,32189,2086,1457,35732,90.08,5.84,4.08
1401,2014,32682,2093,1516,36291,90.06,5.77,4.18
1401,2015,32940,2127,1584,36651,89.87,5.80,4.32
1401,2016,33177,2161,1770,37108,89.41,5.82,4.77
1401,2017,33257,2229,1926,37412,88.89,5.96,5.15
1401,2018,33355,2295,2152,37802,88.24,6.07,5.69
1401,2019,33469,2365,2143,37977,88.13,6.23,5.64
1401,2020,33619,2398,2229,38246,87.90,6.27,5.83
1401,2021,34087,2527,2392,39006,87.39,6.48,6.13
1401,2022,34543,2688,2531,39762,86.87,6.76,6.37
1401,2023,34576,2764,2535,39875,86.71,6.93,6.36
1402,2010,30106,2806,2172,35084,85.81,8.00,6.19
1402,2011,30486,2794,2238,35518,85.83,7.87,6.30
1402,2012,30672,2828,2337,35837,85.59,7.89,6.52
1402,2013,30818,2912,2417,36147,85.26,8.06,6.69
1402,2014,31038,2954,2536,36528,84.97,8.09,6.94
1402,2015,31206,3032,2739,36977,84.39,8.20,7.41
1402,2016,31311,3096,2909,37316,83.91,8.30,7.80
1402,2017,31428,3203,3249,37880,82.97,8.46,8.58
1402,2018,31528,3246,3669,38443,82.01,8.44,9.54
1402,2019,31814,3478,3997,39289,80.97,8.85,10.17
1402,2020,31771,3646,4095,39512,80.41,9.23,10.36
1402,2021,31559,3677,4293,39529,79.84,9.30,10.86
1402,2022,31536,3791,4525,39852,79.13,9.51,11.35
1402,2023,31973,4046,4711,40730,78.50,9.93,11.57
1407,2010,11912,323,214,12449,95.69,2.59,1.72
1407,2011,11949,318,220,12487,95.69,2.55,1.76
1407,2012,11989,335,215,12539,95.61,2.67,1.71
1407,2013,11991,364,219,12574,95.36,2.89,1.74
1407,2014,12040,369,236,12645,95.22,2.92,1.87
1407,2015,12049,403,230,12682,95.01,3.18,1.81
1407,2016,12059,429,285,12773,94.41,3.36,2.23
1407,2017,12109,461,353,12923,93.70,3.57,2.73
1407,2018,12042,483,420,12945,93.02,3.73,3.24
1407,2019,12002,487,427,12916,92.92,3.77,3.31
1407,2020,12038,481,415,12934,93.07,3.72,3.21
1407,2021,11989,476,437,12902,92.92,3.69,3.39
1407,2022,11916,481,403,12800,93.09,3.76,3.15
1407,2023,11954,479,386,12819,93.25,3.74,3.01
1415,2010,22214,1357,721,24292,91.45,5.59,2.97
1415,2011,22438,1398,765,24601,91.21,5.68,3.11
1415,2012,22694,1391,783,24868,91.26,5.59,3.15
1415,2013,22699,1385,848,24932,91.04,5.56,3.40
1415,2014,22973,1420,882,25275,90.89,5.62,3.49
1415,2015,23083,1434,991,25508,90.49,5.62,3.89
1415,2016,23223,1469,1123,25815,89.96,5.69,4.35
1415,2017,23415,1534,1275,26224,89.29,5.85,4.86
1415,2018,23562,1569,1372,26503,88.90,5.92,5.18
1415,2019,23719,1563,1495,26777,88.58,5.84,5.58
1415,2020,23934,1566,1544,27044,88.50,5.79,5.71
1415,2021,24350,1594,1612,27556,88.37,5.78,5.85
1415,2022,24592,1633,1645,27870,88.24,5.86,5.90
1415,2023,24615,1607,1640,27862,88.35,5.77,5.89
1419,2010,14054,621,280,14955,93.98,4.15,1.87
1419,2011,14029,640,290,14959,93.78,4.28,1.94
1419,2012,13984,657,333,14974,93.39,4.39,2.22
1419,2013,14004,684,362,15050,93.05,4.54,2.41
1419,2014,14057,694,384,15135,92.88,4.59,2.54
1419,2015,14201,717,397,15315,92.73,4.68,2.59
1419,2016,14372,720,492,15584,92.22,4.62,3.16
1419,2017,14492,745,553,15790,91.78,4.72,3.50
1419,2018,14544,797,581,15922,91.35,5.01,3.65
1419,2019,14582,826,608,16016,91.05,5.16,3.80
1419,2020,14675,855,617,16147,90.88,5.30,3.82
1419,2021,14800,858,654,16312,90.73,5.26,4.01
1419,2022,14747,850,678,16275,90.61,5.22,4.17
1419,2023,14659,834,653,16146,90.79,5.17,4.04
1421,2010,14320,649,252,15221,94.08,4.26,1.66
1421,2011,14199,656,274,15129,93.85,4.34,1.81
1421,2012,14132,666,285,15083,93.69,4.42,1.89
1421,2013,14058,673,305,15036,93.50,4.48,2.03
1421,2014,14029,690,335,15054,93.19,4.58,2.23
1421,2015,13938,708,364,15010,92.86,4.72,2.43
1421,2016,13908,743,442,15093,92.15,4.92,2.93
1421,2017,13853,769,486,15108,91.69,5.09,3.22
1421,2018,13840,780,490,15110,91.59,5.16,3.24
1421,2019,13899,787,532,15218,91.33,5.17,3.50
1421,2020,13954,809,552,15315,91.11,5.28,3.60
1421,2021,13967,830,548,15345,91.02,5.41,3.57
1421,2022,13991,869,555,15415,90.76,5.64,3.60
1421,2023,13881,899,553,15333,90.53,5.86,3.61
1427,2010,8380,473,199,9052,92.58,5.23,2.20
1427,2011,8320,488,199,9007,92.37,5.42,2.21
1427,2012,8291,505,208,9004,92.08,5.61,2.31
1427,2013,8209,500,219,8928,91.95,5.60,2.45
1427,2014,8207,491,233,8931,91.89,5.50,2.61
1427,2015,8262,482,262,9006,91.74,5.35,2.91
1427,2016,8222,490,353,9065,90.70,5.41,3.89
1427,2017,8199,495,379,9073,90.37,5.46,4.18
1427,2018,8117,508,405,9030,89.89,5.63,4.49
1427,2019,8108,516,437,9061,89.48,5.69,4.82
1427,2020,8165,508,427,9100,89.73,5.58,4.69
1427,2021,8186,520,419,9125,89.71,5.70,4.59
1427,2022,8186,532,442,9160,89.37,5.81,4.83
1427,2023,8066,554,432,9052,89.11,6.12,4.77
1430,2010,9407,607,167,10181,92.40,5.96,1.64
1430,2011,9389,642,192,10223,91.84,6.28,1.88
1430,2012,9348,633,192,10173,91.89,6.22,1.89
1430,2013,9345,622,238,10205,91.57,6.10,2.33
1430,2014,9298,626,319,10243,90.77,6.11,3.11
1430,2015,9227,618,360,10205,90.42,6.06,3.53
1430,2016,9196,625,540,10361,88.76,6.03,5.21
1430,2017,9215,633,575,10423,88.41,6.07,5.52
1430,2018,9240,657,606,10503,87.97,6.26,5.77
1430,2019,9261,666,586,10513,88.09,6.34,5.57
1430,2020,9256,717,609,10582,87.47,6.78,5.76
1430,2021,9294,734,560,10588,87.78,6.93,5.29
1430,2022,9294,717,567,10578,87.86,6.78,5.36
1430,2023,9223,707,572,10502,87.82,6.73,5.45
1435,2010,11200,888,282,12370,90.54,7.18,2.28
1435,2011,11126,911,283,12320,90.31,7.39,2.30
1435,2012,11061,909,300,12270,90.15,7.41,2.44
1435,2013,11067,893,343,12303,89.95,7.26,2.79
1435,2014,11094,870,382,12346,89.86,7.05,3.09
1435,2015,11141,860,454,12455,89.45,6.90,3.65
1435,2016,11170,879,557,12606,88.61,6.97,4.42
1435,2017,11201,884,678,12763,87.76,6.93,5.31
1435,2018,11238,906,729,12873,87.30,7.04,5.66
1435,2019,11212,904,725,12841,87.31,7.04,5.65
1435,2020,11310,889,713,12912,87.59,6.89,5.52
1435,2021,11372,863,730,12965,87.71,6.66,5.63
1435,2022,11403,879,731,13013,87.63,6.75,5.62
1435,2023,11276,901,688,12865,87.65,7.00,5.35
1438,2010,4087,517,88,4692,87.11,11.02,1.88
1438,2011,4064,512,103,4679,86.86,10.94,2.20
1438,2012,4056,510,99,4665,86.95,10.93,2.12
1438,2013,4044,540,156,4740,85.32,11.39,3.29
1438,2014,4063,543,158,4764,85.29,11.40,3.32
1438,2015,4063,537,199,4799,84.66,11.19,4.15
1438,2016,4017,535,225,4777,84.09,11.20,4.71
1438,2017,4000,519,244,4763,83.98,10.90,5.12
1438,2018,4024,531,251,4806,83.73,11.05,5.22
1438,2019,4059,526,228,4813,84.33,10.93,4.74
1438,2020,4049,496,216,4761,85.05,10.42,4.54
1438,2021,4030,504,222,4756,84.74,10.60,4.67
1438,2022,3978,485,187,4650,85.55,10.43,4.02
1438,2023,3932,489,185,4606,85.37,10.62,4.02
1439,2010,6085,401,168,6654,91.45,6.03,2.52
1439,2011,6023,412,171,6606,91.17,6.24,2.59
1439,2012,5972,409,168,6549,91.19,6.25,2.57
1439,2013,5931,377,212,6520,90.97,5.78,3.25
1439,2014,5903,376,223,6502,90.79,5.78,3.43
1439,2015,5830,378,287,6495,89.76,5.82,4.42
1439,2016,5841,400,386,6627,88.14,6.04,5.82
1439,2017,5802,394,396,6592,88.02,5.98,6.01
1439,2018,5802,401,399,6602,87.88,6.07,6.04
1439,2019,5828,396,413,6637,87.81,5.97,6.22
1439,2020,5857,395,406,6658,87.97,5.93,6.10
1439,2021,5802,396,378,6576,88.23,6.02,5.75
1439,2022,5760,408,344,6512,88.45,6.27,5.28
1439,2023,5708,396,330,6434,88.72,6.15,5.13
1440,2010,23915,2300,1227,27442,87.15,8.38,4.47
1440,2011,23969,2335,1273,27577,86.92,8.47,4.62
1440,2012,24151,2353,1338,27842,86.74,8.45,4.81
1440,2013,24321,2344,1409,28074,86.63,8.35,5.02
1440,2014,24497,2385,1541,28423,86.19,8.39,5.42
1440,2015,24802,2404,1656,28862,85.93,8.33,5.74
1440,2016,25169,2498,1882,29549,85.18,8.45,6.37
1440,2017,25505,2602,2116,30223,84.39,8.61,7.00
1440,2018,25878,2710,2338,30926,83.68,8.76,7.56
1440,2019,26065,2809,2528,31402,83.00,8.95,8.05
1440,2020,26343,2853,2672,31868,82.66,8.95,8.38
1440,2021,26485,2917,2746,32148,82.38,9.07,8.54
1440,2022,26471,3019,2904,32394,81.72,9.32,8.96
1440,2023,26438,3047,2961,32446,81.48,9.39,9.13
1441,2010,35280,2027,1273,38580,91.45,5.25,3.30
1441,2011,35446,2055,1287,38788,91.38,5.30,3.32
1441,2012,35662,2070,1338,39070,91.28,5.30,3.42
1441,2013,35883,2055,1381,39319,91.26,5.23,3.51
1441,2014,36258,2066,1447,39771,91.17,5.19,3.64
1441,2015,36547,2122,1512,40181,90.96,5.28,3.76
1441,2016,36842,2204,1646,40692,90.54,5.42,4.05
1441,2017,37257,2260,1993,41510,89.75,5.44,4.80
1441,2018,37671,2274,2192,42137,89.40,5.40,5.20
1441,2019,37900,2345,2323,42568,89.03,5.51,5.46
1441,2020,38314,2367,2339,43020,89.06,5.50,5.44
1441,2021,38543,2424,2432,43399,88.81,5.59,5.60
1441,2022,38650,2448,2438,43536,88.78,5.62,5.60
1441,2023,38775,2483,2448,43706,88.72,5.68,5.60
1442,2010,9996,551,396,10943,91.35,5.04,3.62
1442,2011,10028,546,420,10994,91.21,4.97,3.82
1442,2012,10035,544,451,11030,90.98,4.93,4.09
1442,2013,10021,562,482,11065,90.56,5.08,4.36
1442,2014,10010,549,530,11089,90.27,4.95,4.78
1442,2015,10009,563,593,11165,89.65,5.04,5.31
1442,2016,10036,568,691,11295,88.85,5.03,6.12
1442,2017,10131,578,781,11490,88.17,5.03,6.80
1442,2018,10207,587,864,11658,87.55,5.04,7.41
1442,2019,10279,613,918,11810,87.04,5.19,7.77
1442,2020,10332,639,975,11946,86.49,5.35,8.16
1442,2021,10469,661,1050,12180,85.95,5.43,8.62
1442,2022,10550,656,1062,12268,86.00,5.35,8.66
1442,2023,10640,671,1073,12384,85.92,5.42,8.66
1443,2010,7744,424,207,8375,92.47,5.06,2.47
1443,2011,7714,427,215,8356,92.32,5.11,2.57
1443,2012,7846,437,224,8507,92.23,5.14,2.63
1443,2013,7865,455,242,8562,91.86,5.31,2.83
1443,2014,7938,464,250,8652,91.75,5.36,2.89
1443,2015,8033,506,260,8799,91.29,5.75,2.95
1443,2016,8258,523,321,9102,90.73,5.75,3.53
1443,2017,8344,547,371,9262,90.09,5.91,4.01
1443,2018,8446,560,421,9427,89.59,5.94,4.47
1443,2019,8473,574,448,9495,89.24,6.05,4.72
1443,2020,8536,563,445,9544,89.44,5.90,4.66
1443,2021,8609,573,452,9634,89.36,5.95,4.69
1443,2022,8657,580,466,9703,89.22,5.98,4.80
1443,2023,8717,602,414,9733,89.56,6.19,4.25
1444,2010,5444,222,110,5776,94.25,3.84,1.90
1444,2011,5340,228,106,5674,94.11,4.02,1.87
1444,2012,5287,226,126,5639,93.76,4.01,2.23
1444,2013,5285,228,128,5641,93.69,4.04,2.27
1444,2014,5278,213,139,5630,93.75,3.78,2.47
1444,2015,5271,216,157,5644,93.39,3.83,2.78
1444,2016,5308,230,183,5721,92.78,4.02,3.20
1444,2017,5330,225,195,5750,92.70,3.91,3.39
1444,2018,5302,220,209,5731,92.51,3.84,3.65
1444,2019,5253,227,213,5693,92.27,3.99,3.74
1444,2020,5254,233,198,5685,92.42,4.10,3.48
1444,2021,5283,256,191,5730,92.20,4.47,3.33
1444,2022,5216,239,191,5646,92.38,4.23,3.38
1444,2023,5142,238,183,5563,92.43,4.28,3.29
1445,2010,5205,261,98,5564,93.55,4.69,1.76
1445,2011,5134,258,101,5493,93.46,4.70,1.84
1445,2012,5117,256,129,5502,93.00,4.65,2.34
1445,2013,5096,262,136,5494,92.76,4.77,2.48
1445,2014,5121,256,161,5538,92.47,4.62,2.91
1445,2015,5153,263,174,5590,92.18,4.70,3.11
1445,2016,5154,280,186,5620,91.71,4.98,3.31
1445,2017,5178,266,203,5647,91.69,4.71,3.59
1445,2018,5153,276,242,5671,90.87,4.87,4.27
1445,2019,5105,266,283,5654,90.29,4.70,5.01
1445,2020,5133,284,270,5687,90.26,4.99,4.75
1445,2021,5144,284,270,5698,90.28,4.98,4.74
1445,2022,5161,281,275,5717,90.27,4.92,4.81
1445,2023,5130,279,247,5656,90.70,4.93,4.37
1446,2010,6403,278,71,6752,94.83,4.12,1.05
1446,2011,6383,262,77,6722,94.96,3.90,1.15
1446,2012,6340,266,93,6699,94.64,3.97,1.39
1446,2013,6327,286,144,6757,93.64,4.23,2.13
1446,2014,6333,277,176,6786,93.32,4.08,2.59
1446,2015,6278,273,213,6764,92.81,4.04,3.15
1446,2016,6277,271,365,6913,90.80,3.92,5.28
1446,2017,6279,291,384,6954,90.29,4.18,5.52
1446,2018,6267,298,376,6941,90.29,4.29,5.42
1446,2019,6301,294,345,6940,90.79,4.24,4.97
1446,2020,6327,292,343,6962,90.88,4.19,4.93
1446,2021,6340,297,328,6965,91.03,4.26,4.71
1446,2022,6406,314,337,7057,90.78,4.45,4.78
1446,2023,6412,321,328,7061,90.81,4.55,4.65
1447,2010,4680,419,192,5291,88.45,7.92,3.63
1447,2011,4620,403,228,5251,87.98,7.67,4.34
1447,2012,4541,395,285,5221,86.98,7.57,5.46
1447,2013,4486,377,322,5185,86.52,7.27,6.21
1447,2014,4455,388,397,5240,85.02,7.40,7.58
1447,2015,4429,378,422,5229,84.70,7.23,8.07
1447,2016,4389,397,521,5307,82.70,7.48,9.82
1447,2017,4384,382,514,5280,83.03,7.23,9.73
1447,2018,4358,400,535,5293,82.34,7.56,10.11
1447,2019,4356,396,528,5280,82.50,7.50,10.00
1447,2020,4275,389,505,5169,82.70,7.53,9.77
1447,2021,4298,398,510,5206,82.56,7.65,9.80
1447,2022,4304,414,476,5194,82.86,7.97,9.16
1447,2023,4251,442,426,5119,83.04,8.63,8.32
1452,2010,10214,1049,324,11587,88.15,9.05,2.80
1452,2011,10160,1084,362,11606,87.54,9.34,3.12
1452,2012,10099,1087,387,11573,87.26,9.39,3.34
1452,2013,10019,1080,432,11531,86.89,9.37,3.75
1452,2014,10019,1095,526,11640,86.07,9.41,4.52
1452,2015,9972,1087,560,11619,85.82,9.36,4.82
1452,2016,9969,1094,713,11776,84.66,9.29,6.05
1452,2017,9959,1120,762,11841,84.11,9.46,6.44
1452,2018,9906,1159,809,11874,83.43,9.76,6.81
1452,2019,9923,1163,850,11936,83.14,9.74,7.12
1452,2020,9879,1176,830,11885,83.12,9.89,6.98
1452,2021,9914,1177,846,11937,83.05,9.86,7.09
1452,2022,9866,1235,839,11940,82.63,10.34,7.03
1452,2023,9805,1248,830,11883,82.51,10.50,6.98
1460,2010,8617,961,213,9791,88.01,9.82,2.18
1460,2011,8458,965,257,9680,87.38,9.97,2.65
1460,2012,8355,958,275,9588,87.14,9.99,2.87
1460,2013,8231,963,356,9550,86.19,10.08,3.73
1460,2014,8168,939,449,9556,85.48,9.83,4.70
1460,2015,8093,977,556,9626,84.07,10.15,5.78
1460,2016,8068,985,887,9940,81.17,9.91,8.92
1460,2017,7948,1003,954,9905,80.24,10.13,9.63
1460,2018,7868,967,1011,9846,79.91,9.82,10.27
1460,2019,7786,949,1015,9750,79.86,9.73,10.41
1460,2020,7732,960,899,9591,80.62,10.01,9.37
1460,2021,7609,965,835,9409,80.87,10.26,8.87
1460,2022,7497,975,783,9255,81.00,10.53,8.46
1460,2023,7425,985,728,9138,81.25,10.78,7.97
1461,2010,8148,805,226,9179,88.77,8.77,2.46
1461,2011,8061,784,223,9068,88.90,8.65,2.46
1461,2012,7923,780,243,8946,88.56,8.72,2.72
1461,2013,7851,761,280,8892,88.29,8.56,3.15
1461,2014,7782,759,395,8936,87.09,8.49,4.42
1461,2015,7710,787,672,9169,84.09,8.58,7.33
1461,2016,7672,749,902,9323,82.29,8.03,9.67
1461,2017,7706,753,918,9377,82.18,8.03,9.79
1461,2018,7658,761,935,9354,81.87,8.14,10.00
1461,2019,7587,782,941,9310,81.49,8.40,10.11
1461,2020,7615,780,917,9312,81.78,8.38,9.85
1461,2021,7570,777,921,9268,81.68,8.38,9.94
1461,2022,7539,805,919,9263,81.39,8.69,9.92
1461,2023,7478,793,894,9165,81.59,8.65,9.75
1462,2010,10986,1195,397,12578,87.34,9.50,3.16
1462,2011,10964,1178,398,12540,87.43,9.39,3.17
1462,2012,10966,1179,435,12580,87.17,9.37,3.46
1462,2013,11115,1224,490,12829,86.64,9.54,3.82
1462,2014,11238,1242,551,13031,86.24,9.53,4.23
1462,2015,11304,1262,612,13178,85.78,9.58,4.64
1462,2016,11634,1367,727,13728,84.75,9.96,5.30
1462,2017,11719,1423,819,13961,83.94,10.19,5.87
1462,2018,11727,1439,880,14046,83.49,10.24,6.27
1462,2019,11727,1451,931,14109,83.12,10.28,6.60
1462,2020,11796,1503,983,14282,82.59,10.52,6.88
1462,2021,11879,1600,1030,14509,81.87,11.03,7.10
1462,2022,11828,1633,967,14428,81.98,11.32,6.70
1462,2023,11769,1654,1003,14426,81.58,11.47,6.95
1463,2010,30531,2448,866,33845,90.21,7.23,2.56
1463,2011,30392,2468,931,33791,89.94,7.30,2.76
1463,2012,30287,2485,991,33763,89.70,7.36,2.94
1463,2013,30207,2500,1046,33753,89.49,7.41,3.10
1463,2014,30212,2543,1132,33887,89.16,7.50,3.34
1463,2015,30128,2561,1217,33906,88.86,7.55,3.59
1463,2016,30164,2607,1447,34218,88.15,7.62,4.23
1463,2017,30210,2643,1631,34484,87.61,7.66,4.73
1463,2018,30278,2690,1813,34781,87.05,7.73,5.21
1463,2019,30159,2703,1892,34754,86.78,7.78,5.44
1463,2020,30193,2773,1930,34896,86.52,7.95,5.53
1463,2021,30447,2813,1941,35201,86.49,7.99,5.51
1463,2022,30490,2863,1976,35329,86.30,8.10,5.59
1463,2023,30436,2842,2009,35287,86.25,8.05,5.69
1465,2010,9147,872,269,10288,88.91,8.48,2.61
1465,2011,9110,879,293,10282,88.60,8.55,2.85
1465,2012,9065,853,321,10239,88.53,8.33,3.14
1465,2013,9048,851,400,10299,87.85,8.26,3.88
1465,2014,9036,878,451,10365,87.18,8.47,4.35
1465,2015,9056,895,555,10506,86.20,8.52,5.28
1465,2016,9071,899,709,10679,84.94,8.42,6.64
1465,2017,9060,923,676,10659,85.00,8.66,6.34
1465,2018,9018,947,718,10683,84.41,8.86,6.72
1465,2019,9114,943,723,10780,84.55,8.75,6.71
1465,2020,9047,949,755,10751,84.15,8.83,7.02
1465,2021,9144,991,729,10864,84.17,9.12,6.71
1465,2022,9114,996,706,10816,84.26,9.21,6.53
1465,2023,9042,1014,703,10759,84.04,9.42,6.53
1466,2010,8454,637,223,9314,90.77,6.84,2.39
1466,2011,8391,644,249,9284,90.38,6.94,2.68
1466,2012,8373,647,262,9282,90.21,6.97,2.82
1466,2013,8342,644,288,9274,89.95,6.94,3.11
1466,2014,8394,647,335,9376,89.53,6.90,3.57
1466,2015,8348,640,361,9349,89.29,6.85,3.86
1466,2016,8404,657,425,9486,88.59,6.93,4.48
1466,2017,8370,687,428,9485,88.24,7.24,4.51
1466,2018,8355,707,432,9494,88.00,7.45,4.55
1466,2019,8309,710,445,9464,87.80,7.50,4.70
1466,2020,8315,710,419,9444,88.05,7.52,4.44
1466,2021,8341,730,430,9501,87.79,7.68,4.53
1466,2022,8338,748,431,9517,87.61,7.86,4.53
1466,2023,8270,748,423,9441,87.60,7.92,4.48
1470,2010,14670,738,354,15762,93.07,4.68,2.25
1470,2011,14561,745,388,15694,92.78,4.75,2.47
1470,2012,14412,738,407,15557,92.64,4.74,2.62
1470,2013,14425,747,437,15609,92.41,4.79,2.80
1470,2014,14347,761,489,15597,91.99,4.88,3.14
1470,2015,14318,809,535,15662,91.42,5.17,3.42
1470,2016,14314,847,627,15788,90.66,5.36,3.97
1470,2017,14352,890,700,15942,90.03,5.58,4.39
1470,2018,14292,926,734,15952,89.59,5.80,4.60
1470,2019,14271,981,772,16024,89.06,6.12,4.82
1470,2020,14235,1050,811,16096,88.44,6.52,5.04
1470,2021,14269,1068,825,16162,88.29,6.61,5.10
1470,2022,14214,1109,840,16163,87.94,6.86,5.20
1470,2023,14144,1121,801,16066,88.04,6.98,4.99
1471,2010,12134,767,322,13223,91.76,5.80,2.44
1471,2011,12026,768,340,13134,91.56,5.85,2.59
1471,2012,11967,774,351,13092,91.41,5.91,2.68
1471,2013,11880,762,386,13028,91.19,5.85,2.96
1471,2014,11842,778,460,13080,90.54,5.95,3.52
1471,2015,11855,781,524,13160,90.08,5.93,3.98
1471,2016,11808,771,696,13275,88.95,5.81,5.24
1471,2017,11774,779,689,13242,88.91,5.88,5.20
1471,2018,11727,788,717,13232,88.63,5.96,5.42
1471,2019,11693,790,724,13207,88.54,5.98,5.48
1471,2020,11686,796,712,13194,88.57,6.03,5.40
1471,2021,11715,815,733,13263,88.33,6.14,5.53
1471,2022,11710,820,745,13275,88.21,6.18,5.61
1471,2023,11654,821,743,13218,88.17,6.21,5.62
1472,2010,9508,581,471,10560,90.04,5.50,4.46
1472,2011,9532,600,493,10625,89.71,5.65,4.64
1472,2012,9544,610,519,10673,89.42,5.72,4.86
1472,2013,9557,595,602,10754,88.87,5.53,5.60
1472,2014,9498,588,778,10864,87.43,5.41,7.16
1472,2015,9445,589,946,10980,86.02,5.36,8.62
1472,2016,9409,570,1091,11070,85.00,5.15,9.86
1472,2017,9383,584,1143,11110,84.46,5.26,10.29
1472,2018,9379,585,1204,11168,83.98,5.24,10.78
1472,2019,9387,601,1252,11240,83.51,5.35,11.14
1472,2020,9450,577,1270,11297,83.65,5.11,11.24
1472,2021,9446,582,1253,11281,83.73,5.16,11.11
1472,2022,9554,599,1246,11399,83.81,5.25,10.93
1472,2023,9522,602,1208,11332,84.03,5.31,10.66
1473,2010,8434,511,168,9113,92.55,5.61,1.84
1473,2011,8357,526,180,9063,92.21,5.80,1.99
1473,2012,8242,530,237,9009,91.49,5.88,2.63
1473,2013,8184,517,291,8992,91.01,5.75,3.24
1473,2014,8130,533,409,9072,89.62,5.88,4.51
1473,2015,8173,544,576,9293,87.95,5.85,6.20
1473,2016,8133,526,776,9435,86.20,5.57,8.22
1473,2017,8076,541,797,9414,85.79,5.75,8.47
1473,2018,7996,556,760,9312,85.87,5.97,8.16
1473,2019,7921,574,798,9293,85.24,6.18,8.59
1473,2020,7920,582,779,9281,85.34,6.27,8.39
1473,2021,7903,580,724,9207,85.84,6.30,7.86
1473,2022,7889,577,720,9186,85.88,6.28,7.84
1473,2023,7850,605,686,9141,85.88,6.62,7.50
1480,2010,398738,55175,59838,513751,77.61,10.74,11.65
1480,2011,401771,56226,62377,520374,77.21,10.80,11.99
1480,2012,404777,56669,64643,526089,76.94,10.77,12.29
1480,2013,408176,57459,67636,533271,76.54,10.77,12.68
1480,2014,411181,58551,71413,541145,75.98,10.82,13.20
1480,2015,414046,59663,74481,548190,75.53,10.88,13.59
1480,2016,416547,60561,79532,556640,74.83,10.88,14.29
1480,2017,417102,61860,85077,564039,73.95,10.97,15.08
1480,2018,418178,62929,90761,571868,73.12,11.00,15.87
1480,2019,419939,64008,95334,579281,72.49,11.05,16.46
1480,2020,420985,64061,98010,583056,72.20,10.99,16.81
1480,2021,421490,64562,101497,587549,71.74,10.99,17.27
1480,2022,422904,66361,107576,596841,70.86,11.12,18.02
1480,2023,425797,67678,111141,604616,70.42,11.19,18.38
1481,2010,52862,4093,4018,60973,86.70,6.71,6.59
1481,2011,52973,4162,4202,61337,86.36,6.79,6.85
1481,2012,53091,4246,4322,61659,86.10,6.89,7.01
1481,2013,53208,4252,4518,61978,85.85,6.86,7.29
1481,2014,53662,4410,4855,62927,85.28,7.01,7.72
1481,2015,53778,4554,5008,63340,84.90,7.19,7.91
1481,2016,54258,4803,5404,64465,84.17,7.45,8.38
1481,2017,55026,4964,6131,66121,83.22,7.51,9.27
1481,2018,56116,5310,6726,68152,82.34,7.79,9.87
1481,2019,56792,5445,7127,69364,81.88,7.85,10.27
1481,2020,57017,5542,7342,69901,81.57,7.93,10.50
1481,2021,56797,5579,7567,69943,81.20,7.98,10.82
1481,2022,56624,5763,7722,70109,80.77,8.22,11.01
1481,2023,56747,5838,7949,70534,80.45,8.28,11.27
1482,2010,38021,1926,1294,41241,92.19,4.67,3.14
1482,2011,38281,1916,1341,41538,92.16,4.61,3.23
1482,2012,38440,1932,1381,41753,92.07,4.63,3.31
1482,2013,38701,1960,1448,42109,91.91,4.65,3.44
1482,2014,38812,1985,1537,42334,91.68,4.69,3.63
1482,2015,39155,1984,1591,42730,91.63,4.64,3.72
1482,2016,39531,2006,1752,43289,91.32,4.63,4.05
1482,2017,40002,2095,2013,44110,90.69,4.75,4.56
1482,2018,40553,2166,2367,45086,89.95,4.80,5.25
1482,2019,41426,2272,2638,46336,89.40,4.90,5.69
1482,2020,41949,2355,2746,47050,89.16,5.01,5.84
1482,2021,42904,2448,2919,48271,88.88,5.07,6.05
1482,2022,43518,2546,3004,49068,88.69,5.19,6.12
1482,2023,44137,2603,3045,49785,88.66,5.23,6.12
1484,2010,13125,876,520,14521,90.39,6.03,3.58
1484,2011,13011,864,523,14398,90.37,6.00,3.63
1484,2012,12949,883,564,14396,89.95,6.13,3.92
1484,2013,12838,903,628,14369,89.35,6.28,4.37
1484,2014,12711,917,671,14299,88.89,6.41,4.69
1484,2015,12704,935,825,14464,87.83,6.46,5.70
1484,2016,12648,905,1017,14570,86.81,6.21,6.98
1484,2017,12593,911,1117,14621,86.13,6.23,7.64
1484,2018,12533,913,1165,14611,85.78,6.25,7.97
1484,2019,12470,899,1186,14555,85.68,6.18,8.15
1484,2020,12339,865,1162,14366,85.89,6.02,8.09
1484,2021,12307,853,1106,14266,86.27,5.98,7.75
1484,2022,12173,874,1123,14170,85.91,6.17,7.93
1484,2023,12031,859,1079,13969,86.13,6.15,7.72
1485,2010,45812,3379,2677,51868,88.32,6.51,5.16
1485,2011,45993,3385,2778,52156,88.18,6.49,5.33
1485,2012,46099,3456,2975,52530,87.76,6.58,5.66
1485,2013,46249,3473,3303,53025,87.22,6.55,6.23
1485,2014,46331,3487,3699,53517,86.57,6.52,6.91
1485,2015,46517,3477,4186,54180,85.86,6.42,7.73
1485,2016,46694,3507,4963,55164,84.65,6.36,9.00
1485,2017,46829,3525,5409,55763,83.98,6.32,9.70
1485,2018,46922,3533,5804,56259,83.40,6.28,10.32
1485,2019,46986,3554,6163,56703,82.86,6.27,10.87
1485,2020,46873,3586,6328,56787,82.54,6.31,11.14
1485,2021,47025,3601,6496,57122,82.32,6.30,11.37
1485,2022,47118,3642,6522,57282,82.26,6.36,11.39
1485,2023,46999,3594,6452,57045,82.39,6.30,11.31
1486,2010,9413,1975,420,11808,79.72,16.73,3.56
1486,2011,9469,2038,503,12010,78.84,16.97,4.19
1486,2012,9600,2121,574,12295,78.08,17.25,4.67
1486,2013,9634,2189,657,12480,77.20,17.54,5.26
1486,2014,9670,2298,726,12694,76.18,18.10,5.72
1486,2015,9696,2326,832,12854,75.43,18.10,6.47
1486,2016,9726,2315,1038,13079,74.36,17.70,7.94
1486,2017,9764,2335,1119,13218,73.87,17.67,8.47
1486,2018,9699,2331,1223,13253,73.18,17.59,9.23
1486,2019,9616,2316,1286,13218,72.75,17.52,9.73
1486,2020,9587,2299,1358,13244,72.39,17.36,10.25
1486,2021,9654,2264,1359,13277,72.71,17.05,10.24
1486,2022,9594,2285,1411,13290,72.19,17.19,10.62
1486,2023,9653,2335,1488,13476,71.63,17.33,11.04
1487,2010,33532,2357,968,36857,90.98,6.39,2.63
1487,2011,33538,2377,1047,36962,90.74,6.43,2.83
1487,2012,33377,2412,1179,36968,90.29,6.52,3.19
1487,2013,33412,2451,1506,37369,89.41,6.56,4.03
1487,2014,33390,2511,1989,37890,88.12,6.63,5.25
1487,2015,33347,2565,2469,38381,86.88,6.68,6.43
1487,2016,33288,2602,3065,38955,85.45,6.68,7.87
1487,2017,33328,2652,3171,39151,85.13,6.77,8.10
1487,2018,33386,2676,3349,39411,84.71,6.79,8.50
1487,2019,33360,2706,3525,39591,84.26,6.83,8.90
1487,2020,33439,2727,3458,39624,84.39,6.88,8.73
1487,2021,33423,2748,3465,39636,84.32,6.93,8.74
1487,2022,33594,2813,3497,39904,84.19,7.05,8.76
1487,2023,33785,2799,3428,40012,84.44,7.00,8.57
1488,2010,45943,5363,3942,55248,83.16,9.71,7.14
1488,2011,46040,5316,4143,55499,82.96,9.58,7.46
1488,2012,46046,5342,4361,55749,82.60,9.58,7.82
1488,2013,46200,5381,4992,56573,81.66,9.51,8.82
1488,2014,46143,5385,5401,56929,81.05,9.46,9.49
1488,2015,46005,5388,5699,57092,80.58,9.44,9.98
1488,2016,46159,5380,6214,57753,79.92,9.32,10.76
1488,2017,46208,5439,6591,58238,79.34,9.34,11.32
1488,2018,46273,5429,7026,58728,78.79,9.24,11.96
1488,2019,46204,5504,7350,59058,78.23,9.32,12.45
1488,2020,46161,5460,7628,59249,77.91,9.22,12.87
1488,2021,45983,5496,7675,59154,77.73,9.29,12.97
1488,2022,45845,5580,7849,59274,77.34,9.41,13.24
1488,2023,45612,5598,7863,59073,77.21,9.48,13.31
1489,2010,34350,2165,1281,37796,90.88,5.73,3.39
1489,2011,34503,2178,1372,38053,90.67,5.72,3.61
1489,2012,34644,2201,1510,38355,90.32,5.74,3.94
1489,2013,34791,2209,1619,38619,90.09,5.72,4.19
1489,2014,35163,2227,1798,39188,89.73,5.68,4.59
1489,2015,35402,2269,1931,39602,89.39,5.73,4.88
1489,2016,35630,2268,2147,40045,88.97,5.66,5.36
1489,2017,35778,2301,2311,40390,88.58,5.70,5.72
1489,2018,36221,2350,2499,41070,88.19,5.72,6.08
1489,2019,36450,2354,2616,41420,88.00,5.68,6.32
1489,2020,36576,2333,2693,41602,87.92,5.61,6.47
1489,2021,36816,2309,2728,41853,87.97,5.52,6.52
1489,2022,37041,2362,2796,42199,87.78,5.60,6.63
1489,2023,37170,2360,2852,42382,87.70,5.57,6.73
1490,2010,84464,11036,7794,103294,81.77,10.68,7.55
1490,2011,84904,11150,8052,104106,81.56,10.71,7.73
1490,2012,85195,11266,8406,104867,81.24,10.74,8.02
1490,2013,85594,11329,9072,105995,80.75,10.69,8.56
1490,2014,85916,11444,9662,107022,80.28,10.69,9.03
1490,2015,86296,11603,10589,108488,79.54,10.70,9.76
1490,2016,86590,11650,11640,109880,78.80,10.60,10.59
1490,2017,86677,11817,12532,111026,78.07,10.64,11.29
1490,2018,86815,12059,13304,112178,77.39,10.75,11.86
1490,2019,86848,12243,14088,113179,76.74,10.82,12.45
1490,2020,86819,12272,14623,113714,76.35,10.79,12.86
1490,2021,86603,12265,15223,114091,75.91,10.75,13.34
1490,2022,86328,12403,15714,114445,75.43,10.84,13.73
1490,2023,86442,12235,15915,114592,75.43,10.68,13.89
1491,2010,20696,1447,695,22838,90.62,6.34,3.04
1491,2011,20776,1460,760,22996,90.35,6.35,3.30
1491,2012,20697,1485,833,23015,89.93,6.45,3.62
1491,2013,20799,1503,909,23211,89.61,6.48,3.92
1491,2014,20758,1529,957,23244,89.30,6.58,4.12
1491,2015,20846,1569,1079,23494,88.73,6.68,4.59
1491,2016,21005,1606,1276,23887,87.93,6.72,5.34
1491,2017,21167,1681,1448,24296,87.12,6.92,5.96
1491,2018,21238,1697,1510,24445,86.88,6.94,6.18
1491,2019,21332,1755,1581,24668,86.48,7.11,6.41
1491,2020,21370,1727,1607,24704,86.50,6.99,6.51
1491,2021,21522,1719,1657,24898,86.44,6.90,6.66
1491,2022,21667,1738,1703,25108,86.30,6.92,6.78
1491,2023,21606,1765,1716,25087,86.12,7.04,6.84
1492,2010,11166,731,398,12295,90.82,5.95,3.24
1492,2011,11063,752,411,12226,90.49,6.15,3.36
1492,2012,10994,774,443,12211,90.03,6.34,3.63
1492,2013,10889,804,536,12229,89.04,6.57,4.38
1492,2014,10796,806,724,12326,87.59,6.54,5.87
1492,2015,10765,798,1038,12601,85.43,6.33,8.24
1492,2016,10738,773,1290,12801,83.88,6.04,10.08
1492,2017,10593,764,1354,12711,83.34,6.01,10.65
1492,2018,10537,740,1443,12720,82.84,5.82,11.34
1492,2019,10485,740,1385,12610,83.15,5.87,10.98
1492,2020,10381,720,1340,12441,83.44,5.79,10.77
1492,2021,10350,718,1250,12318,84.02,5.83,10.15
1492,2022,10307,715,1194,12216,84.37,5.85,9.77
1492,2023,10171,713,1122,12006,84.72,5.94,9.35
1493,2010,21539,1540,662,23741,90.72,6.49,2.79
1493,2011,21561,1510,661,23732,90.85,6.36,2.79
1493,2012,21487,1522,730,23739,90.51,6.41,3.08
1493,2013,21455,1534,881,23870,89.88,6.43,3.69
1493,2014,21493,1542,886,23921,89.85,6.45,3.70
1493,2015,21557,1535,951,24043,89.66,6.38,3.96
1493,2016,21562,1563,1090,24215,89.04,6.45,4.50
1493,2017,21549,1581,1160,24290,88.72,6.51,4.78
1493,2018,21559,1588,1225,24372,88.46,6.52,5.03
1493,2019,21629,1594,1314,24537,88.15,6.50,5.36
1493,2020,21628,1552,1333,24513,88.23,6.33,5.44
1493,2021,21739,1611,1373,24723,87.93,6.52,5.55
1493,2022,21683,1629,1456,24768,87.54,6.58,5.88
1493,2023,21600,1598,1449,24647,87.64,6.48,5.88
1494,2010,35106,1859,1083,38048,92.27,4.89,2.85
1494,2011,35158,1871,1154,38183,92.08,4.90,3.02
1494,2012,35159,1875,1220,38254,91.91,4.90,3.19
1494,2013,35210,1870,1334,38414,91.66,4.87,3.47
1494,2014,35408,1855,1498,38761,91.35,4.79,3.86
1494,2015,35537,1873,1599,39009,91.10,4.80,4.10
1494,2016,35539,1871,1825,39235,90.58,4.77,4.65
1494,2017,35556,1854,2096,39506,90.00,4.69,5.31
1494,2018,35735,1862,2282,39879,89.61,4.67,5.72
1494,2019,35808,1863,2418,40089,89.32,4.65,6.03
1494,2020,35924,1862,2542,40328,89.08,4.62,6.30
1494,2021,35989,1858,2613,40460,88.95,4.59,6.46
1494,2022,35922,1859,2676,40457,88.79,4.60,6.61
1494,2023,35960,1855,2724,40539,88.70,4.58,6.72
1495,2010,16620,1040,654,18314,90.75,5.68,3.57
1495,2011,16478,1066,676,18220,90.44,5.85,3.71
1495,2012,16448,1076,757,18281,89.97,5.89,4.14
1495,2013,16425,1138,1017,18580,88.40,6.12,5.47
1495,2014,16411,1124,1212,18747,87.54,6.00,6.47
1495,2015,16233,1145,1333,18711,86.76,6.12,7.12
1495,2016,16163,1172,1644,18979,85.16,6.18,8.66
1495,2017,16016,1207,1620,18843,85.00,6.41,8.60
1495,2018,15882,1232,1715,18829,84.35,6.54,9.11
1495,2019,15743,1289,1805,18837,83.57,6.84,9.58
1495,2020,15601,1286,1808,18695,83.45,6.88,9.67
1495,2021,15635,1303,1794,18732,83.47,6.96,9.58
1495,2022,15605,1360,1790,18755,83.20,7.25,9.54
1495,2023,15542,1372,1740,18654,83.32,7.35,9.33
1496,2010,45277,3367,2758,51402,88.08,6.55,5.37
1496,2011,45527,3383,2851,51761,87.96,6.54,5.51
1496,2012,45846,3371,2995,52212,87.81,6.46,5.74
1496,2013,46160,3392,3307,52859,87.33,6.42,6.26
1496,2014,46152,3406,3576,53134,86.86,6.41,6.73
1496,2015,46271,3464,3820,53555,86.40,6.47,7.13
1496,2016,46438,3472,4223,54133,85.79,6.41,7.80
1496,2017,46833,3490,4652,54975,85.19,6.35,8.46
1496,2018,47215,3547,4967,55729,84.72,6.36,8.91
1496,2019,47531,3581,5254,56366,84.33,6.35,9.32
1496,2020,47750,3634,5407,56791,84.08,6.40,9.52
1496,2021,47760,3632,5624,57016,83.77,6.37,9.86
1496,2022,47964,3679,5820,57463,83.47,6.40,10.13
1496,2023,48085,3729,5949,57763,83.25,6.46,10.30
1497,2010,8318,377,146,8841,94.08,4.26,1.65
1497,2011,8258,367,165,8790,93.95,4.18,1.88
1497,2012,8265,382,185,8832,93.58,4.33,2.09
1497,2013,8229,387,189,8805,93.46,4.40,2.15
1497,2014,8280,395,210,8885,93.19,4.45,2.36
1497,2015,8288,405,290,8983,92.26,4.51,3.23
1497,2016,8317,405,326,9048,91.92,4.48,3.60
1497,2017,8339,406,348,9093,91.71,4.46,3.83
1497,2018,8394,407,375,9176,91.48,4.44,4.09
1497,2019,8402,423,385,9210,91.23,4.59,4.18
1497,2020,8425,428,376,9229,91.29,4.64,4.07
1497,2021,8423,433,377,9233,91.23,4.69,4.08
1497,2022,8431,432,380,9243,91.21,4.67,4.11
1497,2023,8431,448,379,9258,91.07,4.84,4.09
1498,2010,11640,690,242,12572,92.59,5.49,1.92
1498,2011,11597,712,260,12569,92.27,5.66,2.07
1498,2012,11540,710,306,12556,91.91,5.65,2.44
1498,2013,11524,674,367,12565,91.72,5.36,2.92
1498,2014,11428,691,498,12617,90.58,5.48,3.95
1498,2015,11408,681,580,12669,90.05,5.38,4.58
1498,2016,11440,662,695,12797,89.40,5.17,5.43
1498,2017,11431,669,727,12827,89.12,5.22,5.67
1498,2018,11392,673,763,12828,88.81,5.25,5.95
1498,2019,11384,694,768,12846,88.62,5.40,5.98
1498,2020,11364,696,730,12790,88.85,5.44,5.71
1498,2021,11398,694,733,12825,88.87,5.41,5.72
1498,2022,11401,715,723,12839,88.80,5.57,5.63
1498,2023,11407,719,713,12839,88.85,5.60,5.55
1499,2010,28629,1522,1362,31513,90.85,4.83,4.32
1499,2011,28649,1579,1461,31689,90.41,4.98,4.61
1499,2012,28569,1555,1565,31689,90.15,4.91,4.94
1499,2013,28499,1547,1942,31988,89.09,4.84,6.07
1499,2014,28415,1562,2208,32185,88.29,4.85,6.86
1499,2015,28430,1573,2508,32511,87.45,4.84,7.71
1499,2016,28399,1582,2825,32806,86.57,4.82,8.61
1499,2017,28437,1584,3056,33077,85.97,4.79,9.24
1499,2018,28347,1612,3196,33155,85.50,4.86,9.64
1499,2019,28221,1630,3395,33246,84.89,4.90,10.21
1499,2020,28220,1619,3399,33238,84.90,4.87,10.23
1499,2021,28196,1609,3465,33270,84.75,4.84,10.41
1499,2022,28178,1623,3451,33252,84.74,4.88,10.38
1499,2023,27970,1602,3419,32991,84.78,4.86,10.36
1715,2010,11000,458,248,11706,93.97,3.91,2.12
1715,2011,10961,463,258,11682,93.83,3.96,2.21
1715,2012,11028,470,284,11782,93.60,3.99,2.41
1715,2013,11047,467,296,11810,93.54,3.95,2.51
1715,2014,11079,473,333,11885,93.22,3.98,2.80
1715,2015,10998,461,343,11802,93.19,3.91,2.91
1715,2016,10979,451,370,11800,93.04,3.82,3.14
1715,2017,11050,444,416,11910,92.78,3.73,3.49
1715,2018,11056,454,452,11962,92.43,3.80,3.78
1715,2019,11121,481,485,12087,92.01,3.98,4.01
1715,2020,11149,492,474,12115,92.03,4.06,3.91
1715,2021,11158,504,472,12134,91.96,4.15,3.89
1715,2022,11140,520,455,12115,91.95,4.29,3.76
1715,2023,11098,531,456,12085,91.83,4.39,3.77
1730,2010,6504,1862,158,8524,76.30,21.84,1.85
1730,2011,6434,1857,169,8460,76.05,21.95,2.00
1730,2012,6430,1863,203,8496,75.68,21.93,2.39
1730,2013,6367,1830,229,8426,75.56,21.72,2.72
1730,2014,6340,1843,270,8453,75.00,21.80,3.19
1730,2015,6337,1832,336,8505,74.51,21.54,3.95
1730,2016,6294,1825,407,8526,73.82,21.41,4.77
1730,2017,6269,1850,499,8618,72.74,21.47,5.79
1730,2018,6182,1845,548,8575,72.09,21.52,6.39
1730,2019,6151,1812,601,8564,71.82,21.16,7.02
1730,2020,6129,1808,613,8550,71.68,21.15,7.17
1730,2021,6134,1750,606,8490,72.25,20.61,7.14
1730,2022,6142,1744,649,8535,71.96,20.43,7.60
1730,2023,6107,1726,666,8499,71.86,20.31,7.84
1737,2010,11254,950,210,12414,90.66,7.65,1.69
1737,2011,11127,959,226,12312,90.38,7.79,1.84
1737,2012,11015,951,253,12219,90.15,7.78,2.07
1737,2013,10781,960,272,12013,89.74,7.99,2.26
1737,2014,10645,972,375,11992,88.77,8.11,3.13
1737,2015,10508,968,434,11910,88.23,8.13,3.64
1737,2016,10435,982,752,12169,85.75,8.07,6.18
1737,2017,10335,980,575,11890,86.92,8.24,4.84
1737,2018,10217,968,534,11719,87.18,8.26,4.56
1737,2019,10073,1003,540,11616,86.72,8.63,4.65
1737,2020,9995,1026,528,11549,86.54,8.88,4.57
1737,2021,9897,1055,520,11472,86.27,9.20,4.53
1737,2022,9822,1109,480,11411,86.07,9.72,4.21
1737,2023,9753,1137,497,11387,85.65,9.99,4.36
1760,2010,3641,415,217,4273,85.21,9.71,5.08
1760,2011,3588,403,227,4218,85.06,9.55,5.38
1760,2012,3534,396,220,4150,85.16,9.54,5.30
1760,2013,3457,404,270,4131,83.68,9.78,6.54
1760,2014,3364,414,328,4106,81.93,10.08,7.99
1760,2015,3334,403,295,4032,82.69,10.00,7.32
1760,2016,3295,402,349,4046,81.44,9.94,8.63
1760,2017,3352,415,356,4123,81.30,10.07,8.63
1760,2018,3335,401,319,4055,82.24,9.89,7.87
1760,2019,3378,405,231,4014,84.16,10.09,5.75
1760,2020,3374,409,207,3990,84.56,10.25,5.19
1760,2021,3365,400,183,3948,85.23,10.13,4.64
1760,2022,3316,402,164,3882,85.42,10.36,4.22
1760,2023,3245,414,142,3801,85.37,10.89,3.74
1761,2010,14038,592,296,14926,94.05,3.97,1.98
1761,2011,14045,599,299,14943,93.99,4.01,2.00
1761,2012,14139,612,310,15061,93.88,4.06,2.06
1761,2013,14198,611,327,15136,93.80,4.04,2.16
1761,2014,14322,615,319,15256,93.88,4.03,2.09
1761,2015,14458,614,348,15420,93.76,3.98,2.26
1761,2016,14720,622,383,15725,93.61,3.96,2.44
1761,2017,14992,712,470,16174,92.69,4.40,2.91
1761,2018,15232,734,517,16483,92.41,4.45,3.14
1761,2019,15339,678,551,16568,92.58,4.09,3.33
1761,2020,15444,671,553,16668,92.66,4.03,3.32
1761,2021,15528,673,564,16765,92.62,4.01,3.36
1761,2022,15557,663,600,16820,92.49,3.94,3.57
1761,2023,15673,656,611,16940,92.52,3.87,3.61
1762,2010,3492,220,59,3771,92.60,5.83,1.56
1762,2011,3429,217,56,3702,92.63,5.86,1.51
1762,2012,3341,232,69,3642,91.74,6.37,1.89
1762,2013,3334,248,74,3656,91.19,6.78,2.02
1762,2014,3305,270,81,3656,90.40,7.39,2.22
1762,2015,3267,256,140,3663,89.19,6.99,3.82
1762,2016,3217,287,234,3738,86.06,7.68,6.26
1762,2017,3221,308,234,3763,85.60,8.18,6.22
1762,2018,3213,330,246,3789,84.80,8.71,6.49
1762,2019,3188,335,217,3740,85.24,8.96,5.80
1762,2020,3175,354,196,3725,85.23,9.50,5.26
1762,2021,3128,382,170,3680,85.00,10.38,4.62
1762,2022,3122,415,164,3701,84.36,11.21,4.43
1762,2023,3088,429,152,3669,84.16,11.69,4.14
1763,2010,10570,434,262,11266,93.82,3.85,2.33
1763,2011,10502,449,278,11229,93.53,4.00,2.48
1763,2012,10545,456,310,11311,93.23,4.03,2.74
1763,2013,10502,456,334,11292,93.00,4.04,2.96
1763,2014,10517,466,396,11379,92.42,4.10,3.48
1763,2015,10474,497,408,11379,92.05,4.37,3.59
1763,2016,10460,508,483,11451,91.35,4.44,4.22
1763,2017,10474,516,519,11509,91.01,4.48,4.51
1763,2018,10444,524,550,11518,90.68,4.55,4.78
1763,2019,10464,494,541,11499,91.00,4.30,4.70
1763,2020,10490,490,544,11524,91.03,4.25,4.72
1763,2021,10568,489,549,11606,91.06,4.21,4.73
1763,2022,10538,492,548,11578,91.02,4.25,4.73
1763,2023,10463,513,562,11538,90.68,4.45,4.87
1764,2010,8321,581,189,9091,91.53,6.39,2.08
1764,2011,8275,565,177,9017,91.77,6.27,1.96
1764,2012,8184,549,206,8939,91.55,6.14,2.30
1764,2013,8134,549,242,8925,91.14,6.15,2.71
1764,2014,8096,551,311,8958,90.38,6.15,3.47
1764,2015,8057,530,358,8945,90.07,5.93,4.00
1764,2016,8055,519,489,9063,88.88,5.73,5.40
1764,2017,8002,526,483,9011,88.80,5.84,5.36
1764,2018,8011,539,466,9016,88.85,5.98,5.17
1764,2019,8009,564,474,9047,88.53,6.23,5.24
1764,2020,7995,574,474,9043,88.41,6.35,5.24
1764,2021,8044,573,474,9091,88.48,6.30,5.21
1764,2022,8020,622,463,9105,88.08,6.83,5.09
1764,2023,7962,636,459,9057,87.91,7.02,5.07
1765,2010,8155,1477,223,9855,82.75,14.99,2.26
1765,2011,8092,1507,228,9827,82.34,15.34,2.32
1765,2012,8076,1536,252,9864,81.87,15.57,2.55
1765,2013,8017,1557,379,9953,80.55,15.64,3.81
1765,2014,7905,1540,359,9804,80.63,15.71,3.66
1765,2015,7869,1581,419,9869,79.73,16.02,4.25
1765,2016,7864,1546,548,9958,78.97,15.53,5.50
1765,2017,7829,1527,592,9948,78.70,15.35,5.95
1765,2018,7817,1587,607,10011,78.08,15.85,6.06
1765,2019,7807,1592,671,10070,77.53,15.81,6.66
1765,2020,7771,1556,669,9996,77.74,15.57,6.69
1765,2021,7730,1523,689,9942,77.75,15.32,6.93
1765,2022,7734,1515,665,9914,78.01,15.28,6.71
1765,2023,7704,1544,645,9893,77.87,15.61,6.52
1766,2010,12481,597,177,13255,94.16,4.50,1.34
1766,2011,12353,602,187,13142,94.00,4.58,1.42
1766,2012,12296,611,195,13102,93.85,4.66,1.49
1766,2013,12185,614,212,13011,93.65,4.72,1.63
1766,2014,12133,637,329,13099,92.63,4.86,2.51
1766,2015,12050,641,517,13208,91.23,4.85,3.91
1766,2016,12022,664,739,13425,89.55,4.95,5.50
1766,2017,11962,683,686,13331,89.73,5.12,5.15
1766,2018,11911,693,657,13261,89.82,5.23,4.95
1766,2019,11937,702,667,13306,89.71,5.28,5.01
1766,2020,11971,714,650,13335,89.77,5.35,4.87
1766,2021,11999,752,604,13355,89.85,5.63,4.52
1766,2022,12009,820,589,13418,89.50,6.11,4.39
1766,2023,11910,869,587,13366,89.11,6.50,4.39
1780,2010,76982,4430,4341,85753,89.77,5.17,5.06
1780,2011,77503,4517,4389,86409,89.69,5.23,5.08
1780,2012,77825,4564,4540,86929,89.53,5.25,5.22
1780,2013,78404,4613,4769,87786,89.31,5.25,5.43
1780,2014,78686,4661,5003,88350,89.06,5.28,5.66
1780,2015,79177,4736,5332,89245,88.72,5.31,5.97
1780,2016,79424,4830,5944,90198,88.06,5.35,6.59
1780,2017,79614,4961,6545,91120,87.37,5.44,7.18
1780,2018,80380,5022,7095,92497,86.90,5.43,7.67
1780,2019,81043,5129,7726,93898,86.31,5.46,8.23
1780,2020,81511,5206,8111,94828,85.96,5.49,8.55
1780,2021,81831,5175,8402,95408,85.77,5.42,8.81
1780,2022,82379,5286,8801,96466,85.40,5.48,9.12
1780,2023,82917,5303,9013,97233,85.28,5.45,9.27
1781,2010,21680,1360,768,23808,91.06,5.71,3.23
1781,2011,21524,1371,803,23698,90.83,5.79,3.39
1781,2012,21405,1407,917,23729,90.21,5.93,3.86
1781,2013,21392,1407,1150,23949,89.32,5.87,4.80
1781,2014,21295,1392,1427,24114,88.31,5.77,5.92
1781,2015,21167,1399,1704,24270,87.21,5.76,7.02
1781,2016,21161,1398,2112,24671,85.77,5.67,8.56
1781,2017,21128,1406,2116,24650,85.71,5.70,8.58
1781,2018,20912,1359,2065,24336,85.93,5.58,8.49
1781,2019,20825,1361,2069,24255,85.86,5.61,8.53
1781,2020,20750,1375,2065,24190,85.78,5.68,8.54
1781,2021,20709,1329,2061,24099,85.93,5.51,8.55
1781,2022,20713,1343,1997,24053,86.11,5.58,8.30
1781,2023,20550,1342,1925,23817,86.28,5.63,8.08
1782,2010,9510,705,347,10562,90.04,6.67,3.29
1782,2011,9395,688,431,10514,89.36,6.54,4.10
1782,2012,9306,696,547,10549,88.22,6.60,5.19
1782,2013,9189,697,677,10563,86.99,6.60,6.41
1782,2014,9123,719,771,10613,85.96,6.77,7.26
1782,2015,8984,713,928,10625,84.56,6.71,8.73
1782,2016,8920,711,1329,10960,81.39,6.49,12.13
1782,2017,8836,725,1222,10783,81.94,6.72,11.33
1782,2018,8755,727,1355,10837,80.79,6.71,12.50
1782,2019,8655,713,1276,10644,81.31,6.70,11.99
1782,2020,8578,703,1222,10503,81.67,6.69,11.63
1782,2021,8545,722,1136,10403,82.14,6.94,10.92
1782,2022,8458,752,1105,10315,82.00,7.29,10.71
1782,2023,8310,754,970,10034,82.82,7.51,9.67
1783,2010,11386,878,216,12480,91.23,7.04,1.73
1783,2011,11167,880,235,12282,90.92,7.16,1.91
1783,2012,10995,919,256,12170,90.35,7.55,2.10
1783,2013,10762,922,387,12071,89.16,7.64,3.21
1783,2014,10602,919,400,11921,88.94,7.71,3.36
1783,2015,10440,910,474,11824,88.29,7.70,4.01
1783,2016,10365,922,630,11917,86.98,7.74,5.29
1783,2017,10217,939,626,11782,86.72,7.97,5.31
1783,2018,10064,997,637,11698,86.03,8.52,5.45
1783,2019,9934,1021,651,11606,85.59,8.80,5.61
1783,2020,9858,1051,608,11517,85.60,9.13,5.28
1783,2021,9801,1161,591,11553,84.84,10.05,5.12
1783,2022,9680,1343,566,11589,83.53,11.59,4.88
1783,2023,9572,1422,542,11536,82.98,12.33,4.70
1784,2010,23429,1791,814,26034,89.99,6.88,3.13
1784,2011,23285,1764,858,25907,89.88,6.81,3.31
1784,2012,23165,1782,882,25829,89.69,6.90,3.41
1784,2013,23090,1763,964,25817,89.44,6.83,3.73
1784,2014,22948,1747,1076,25771,89.05,6.78,4.18
1784,2015,22920,1754,1167,25841,88.70,6.79,4.52
1784,2016,22928,1751,1375,26054,88.00,6.72,5.28
1784,2017,22875,1738,1447,26060,87.78,6.67,5.55
1784,2018,22856,1737,1489,26082,87.63,6.66,5.71
1784,2019,22810,1729,1506,26045,87.58,6.64,5.78
1784,2020,22700,1717,1515,25932,87.54,6.62,5.84
1784,2021,22647,1726,1481,25854,87.60,6.68,5.73
1784,2022,22578,1780,1474,25832,87.40,6.89,5.71
1784,2023,22389,1802,1491,25682,87.18,7.02,5.81
1785,2010,14391,834,322,15547,92.56,5.36,2.07
1785,2011,14184,838,372,15394,92.14,5.44,2.42
1785,2012,14045,842,421,15308,91.75,5.50,2.75
1785,2013,13889,826,561,15276,90.92,5.41,3.67
1785,2014,13719,856,759,15334,89.47,5.58,4.95
1785,2015,13565,871,930,15366,88.28,5.67,6.05
1785,2016,13489,891,1253,15633,86.29,5.70,8.02
1785,2017,13439,920,1368,15727,85.45,5.85,8.70
1785,2018,13334,938,1371,15643,85.24,6.00,8.76
1785,2019,13181,930,1344,15455,85.29,6.02,8.70
1785,2020,13180,932,1308,15420,85.47,6.04,8.48
1785,2021,13201,953,1242,15396,85.74,6.19,8.07
1785,2022,13071,993,1178,15242,85.76,6.51,7.73
1785,2023,12873,1004,1134,15011,85.76,6.69,7.55
1814,2010,6856,201,77,7134,96.10,2.82,1.08
1814,2011,6946,201,76,7223,96.17,2.78,1.05
1814,2012,7006,212,80,7298,96.00,2.90,1.10
1814,2013,6989,209,91,7289,95.88,2.87,1.25
1814,2014,7044,212,107,7363,95.67,2.88,1.45
1814,2015,7138,224,130,7492,95.27,2.99,1.74
1814,2016,7236,220,180,7636,94.76,2.88,2.36
1814,2017,7383,255,230,7868,93.84,3.24,2.92
1814,2018,7565,271,280,8116,93.21,3.34,3.45
1814,2019,7643,297,294,8234,92.82,3.61,3.57
1814,2020,7853,326,293,8472,92.69,3.85,3.46
1814,2021,7958,348,297,8603,92.50,4.05,3.45
1814,2022,8114,349,293,8756,92.67,3.99,3.35
1814,2023,7991,316,299,8606,92.85,3.67,3.47
1860,2010,5105,488,93,5686,89.78,8.58,1.64
1860,2011,5036,488,98,5622,89.58,8.68,1.74
1860,2012,4925,491,136,5552,88.71,8.84,2.45
1860,2013,4866,483,231,5580,87.20,8.66,4.14
1860,2014,4803,508,353,5664,84.80,8.97,6.23
1860,2015,4727,507,422,5656,83.57,8.96,7.46
1860,2016,4708,480,521,5709,82.47,8.41,9.13
1860,2017,4646,484,513,5643,82.33,8.58,9.09
1860,2018,4622,491,524,5637,81.99,8.71,9.30
1860,2019,4670,468,545,5683,82.17,8.24,9.59
1860,2020,4652,468,539,5659,82.21,8.27,9.52
1860,2021,4592,464,526,5582,82.26,8.31,9.42
1860,2022,4554,476,546,5576,81.67,8.54,9.79
1860,2023,4494,457,546,5497,81.75,8.31,9.93
1861,2010,13802,822,651,15275,90.36,5.38,4.26
1861,2011,13721,813,714,15248,89.99,5.33,4.68
1861,2012,13685,827,771,15283,89.54,5.41,5.04
1861,2013,13651,806,810,15267,89.42,5.28,5.31
1861,2014,13605,828,882,15315,88.83,5.41,5.76
1861,2015,13614,864,1031,15509,87.78,5.57,6.65
1861,2016,13521,887,1241,15649,86.40,5.67,7.93
1861,2017,13481,922,1529,15932,84.62,5.79,9.60
1861,2018,13397,931,1626,15954,83.97,5.84,10.19
1861,2019,13337,933,1662,15932,83.71,5.86,10.43
1861,2020,13391,954,1645,15990,83.75,5.97,10.29
1861,2021,13532,1003,1661,16196,83.55,6.19,10.26
1861,2022,13563,1086,1641,16290,83.26,6.67,10.07
1861,2023,13472,1111,1649,16232,83.00,6.84,10.16
1862,2010,8597,759,285,9641,89.17,7.87,2.96
1862,2011,8493,747,311,9551,88.92,7.82,3.26
1862,2012,8383,736,358,9477,88.46,7.77,3.78
1862,2013,8386,718,396,9500,88.27,7.56,4.17
1862,2014,8325,719,487,9531,87.35,7.54,5.11
1862,2015,8270,697,576,9543,86.66,7.30,6.04
1862,2016,8212,712,685,9609,85.46,7.41,7.13
1862,2017,8194,705,769,9668,84.75,7.29,7.95
1862,2018,8139,719,807,9665,84.21,7.44,8.35
1862,2019,8114,716,836,9666,83.94,7.41,8.65
1862,2020,8112,698,821,9631,84.23,7.25,8.52
1862,2021,8022,683,829,9534,84.14,7.16,8.70
1862,2022,8029,679,822,9530,84.25,7.12,8.63
1862,2023,7901,663,793,9357,84.44,7.09,8.47
1863,2010,6115,726,379,7220,84.70,10.06,5.25
1863,2011,6039,724,377,7140,84.58,10.14,5.28
1863,2012,5895,728,365,6988,84.36,10.42,5.22
1863,2013,5849,729,404,6982,83.77,10.44,5.79
1863,2014,5769,719,448,6936,83.17,10.37,6.46
1863,2015,5714,723,595,7032,81.26,10.28,8.46
1863,2016,5650,706,782,7138,79.15,9.89,10.96
1863,2017,5557,695,857,7109,78.17,9.78,12.06
1863,2018,5482,672,829,6983,78.50,9.62,11.87
1863,2019,5477,651,885,7013,78.10,9.28,12.62
1863,2020,5420,667,809,6896,78.60,9.67,11.73
1863,2021,5415,663,771,6849,79.06,9.68,11.26
1863,2022,5333,648,675,6656,80.12,9.74,10.14
1863,2023,5207,668,620,6495,80.17,10.28,9.55
1864,2010,4367,468,96,4931,88.56,9.49,1.95
1864,2011,4297,455,118,4870,88.23,9.34,2.42
1864,2012,4232,466,150,4848,87.29,9.61,3.09
1864,2013,4158,462,255,4875,85.29,9.48,5.23
1864,2014,4090,442,381,4913,83.25,9.00,7.75
1864,2015,4026,460,442,4928,81.70,9.33,8.97
1864,2016,3960,477,569,5006,79.11,9.53,11.37
1864,2017,3912,482,548,4942,79.16,9.75,11.09
1864,2018,3905,470,471,4846,80.58,9.70,9.72
1864,2019,3876,467,428,4771,81.24,9.79,8.97
1864,2020,3842,463,369,4674,82.20,9.91,7.89
1864,2021,3786,477,341,4604,82.23,10.36,7.41
1864,2022,3718,476,323,4517,82.31,10.54,7.15
1864,2023,3629,481,297,4407,82.35,10.91,6.74
1880,2010,115377,9079,11004,135460,85.17,6.70,8.12
1880,2011,116618,9166,11337,137121,85.05,6.68,8.27
1880,2012,117680,9261,12011,138952,84.69,6.66,8.64
1880,2013,118627,9332,12640,140599,84.37,6.64,8.99
1880,2014,119809,9448,13361,142618,84.01,6.62,9.37
1880,2015,120672,9610,13918,144200,83.68,6.66,9.65
1880,2016,121909,9796,14926,146631,83.14,6.68,10.18
1880,2017,123828,9980,16483,150291,82.39,6.64,10.97
1880,2018,125354,10196,17817,153367,81.73,6.65,11.62
1880,2019,126375,10425,18896,155696,81.17,6.70,12.14
1880,2020,126586,10410,19385,156381,80.95,6.66,12.40
1880,2021,126735,10379,19873,156987,80.73,6.61,12.66
1880,2022,127162,10474,20421,158057,80.45,6.63,12.92
1880,2023,127862,10614,20872,159348,80.24,6.66,13.10
1881,2010,18405,1074,977,20456,89.97,5.25,4.78
1881,2011,18441,1069,1000,20510,89.91,5.21,4.88
1881,2012,18546,1089,1103,20738,89.43,5.25,5.32
1881,2013,18674,1084,1146,20904,89.33,5.19,5.48
1881,2014,18684,1096,1236,21016,88.90,5.22,5.88
1881,2015,18771,1110,1273,21154,88.73,5.25,6.02
1881,2016,18821,1122,1391,21334,88.22,5.26,6.52
1881,2017,18887,1115,1504,21506,87.82,5.18,6.99
1881,2018,18890,1152,1598,21640,87.29,5.32,7.38
1881,2019,18925,1134,1679,21738,87.06,5.22,7.72
1881,2020,18980,1136,1746,21862,86.82,5.20,7.99
1881,2021,19153,1173,1818,22144,86.49,5.30,8.21
1881,2022,19350,1225,1904,22479,86.08,5.45,8.47
1881,2023,19326,1242,1948,22516,85.83,5.52,8.65
1882,2010,10694,458,126,11278,94.82,4.06,1.12
1882,2011,10540,463,131,11134,94.66,4.16,1.18
1882,2012,10396,477,138,11011,94.41,4.33,1.25
1882,2013,10378,470,248,11096,93.53,4.24,2.24
1882,2014,10380,469,270,11119,93.35,4.22,2.43
1882,2015,10334,463,354,11151,92.67,4.15,3.17
1882,2016,10310,451,521,11282,91.38,4.00,4.62
1882,2017,10251,450,474,11175,91.73,4.03,4.24
1882,2018,10338,459,516,11313,91.38,4.06,4.56
1882,2019,10378,455,544,11377,91.22,4.00,4.78
1882,2020,10438,473,560,11471,90.99,4.12,4.88
1882,2021,10480,487,567,11534,90.86,4.22,4.92
1882,2022,10437,483,577,11497,90.78,4.20,5.02
1882,2023,10402,512,564,11478,90.63,4.46,4.91
1883,2010,26245,2240,1183,29668,88.46,7.55,3.99
1883,2011,26082,2266,1268,29616,88.07,7.65,4.28
1883,2012,25965,2242,1424,29631,87.63,7.57,4.81
1883,2013,25853,2216,1659,29728,86.97,7.45,5.58
1883,2014,25878,2198,1978,30054,86.11,7.31,6.58
1883,2015,25834,2146,2303,30283,85.31,7.09,7.60
1883,2016,25725,2146,2667,30538,84.24,7.03,8.73
1883,2017,25538,2102,2773,30413,83.97,6.91,9.12
1883,2018,25468,2056,2895,30419,83.72,6.76,9.52
1883,2019,25340,2023,3018,30381,83.41,6.66,9.93
1883,2020,25265,2047,2951,30263,83.48,6.76,9.75
1883,2021,25385,2054,2998,30437,83.40,6.75,9.85
1883,2022,25246,2027,3005,30278,83.38,6.69,9.92
1883,2023,25253,1993,3015,30261,83.45,6.59,9.96
1884,2010,9438,595,414,10447,90.34,5.70,3.96
1884,2011,9372,613,444,10429,89.86,5.88,4.26
1884,2012,9287,621,448,10356,89.68,6.00,4.33
1884,2013,9301,632,466,10399,89.44,6.08,4.48
1884,2014,9220,637,495,10352,89.06,6.15,4.78
1884,2015,9240,629,633,10502,87.98,5.99,6.03
1884,2016,9204,630,831,10665,86.30,5.91,7.79
1884,2017,9233,610,904,10747,85.91,5.68,8.41
1884,2018,9203,624,910,10737,85.71,5.81,8.48
1884,2019,9204,624,898,10726,85.81,5.82,8.37
1884,2020,9182,625,879,10686,85.93,5.85,8.23
1884,2021,9252,620,849,10721,86.30,5.78,7.92
1884,2022,9245,622,834,10701,86.39,5.81,7.79
1884,2023,9225,615,787,10627,86.81,5.79,7.41
1885,2010,20490,1376,1168,23034,88.96,5.97,5.07
1885,2011,20444,1391,1273,23108,88.47,6.02,5.51
1885,2012,20262,1385,1332,22979,88.18,6.03,5.80
1885,2013,20185,1379,1612,23176,87.09,5.95,6.96
1885,2014,20156,1390,1723,23269,86.62,5.97,7.40
1885,2015,20134,1378,2050,23562,85.45,5.85,8.70
1885,2016,20080,1369,2295,23744,84.57,5.77,9.67
1885,2017,19905,1410,2298,23613,84.30,5.97,9.73
1885,2018,19856,1395,2324,23575,84.22,5.92,9.86
1885,2019,19872,1409,2307,23588,84.25,5.97,9.78
1885,2020,19993,1435,2230,23658,84.51,6.07,9.43
1885,2021,19986,1420,2195,23601,84.68,6.02,9.30
1885,2022,19882,1437,2116,23435,84.84,6.13,9.03
1885,2023,19784,1446,2062,23292,84.94,6.21,8.85
1904,2010,3811,560,74,4445,85.74,12.60,1.66
1904,2011,3758,565,89,4412,85.18,12.81,2.02
1904,2012,3729,552,111,4392,84.90,12.57,2.53
1904,2013,3669,560,182,4411,83.18,12.70,4.13
1904,2014,3658,559,217,4434,82.50,12.61,4.89
1904,2015,3638,566,268,4472,81.35,12.66,5.99
1904,2016,3620,557,252,4429,81.73,12.58,5.69
1904,2017,3627,551,253,4431,81.86,12.44,5.71
1904,2018,3645,541,243,4429,82.30,12.21,5.49
1904,2019,3601,536,256,4393,81.97,12.20,5.83
1904,2020,3599,528,239,4366,82.43,12.09,5.47
1904,2021,3585,545,241,4371,82.02,12.47,5.51
1904,2022,3621,538,243,4402,82.26,12.22,5.52
1904,2023,3569,536,243,4348,82.08,12.33,5.59
1907,2010,8120,1502,327,9949,81.62,15.10,3.29
1907,2011,8030,1513,328,9871,81.35,15.33,3.32
1907,2012,8029,1505,356,9890,81.18,15.22,3.60
1907,2013,7962,1479,393,9834,80.96,15.04,4.00
1907,2014,7982,1469,467,9918,80.48,14.81,4.71
1907,2015,7998,1448,539,9985,80.10,14.50,5.40
1907,2016,8028,1424,607,10059,79.81,14.16,6.03
1907,2017,8003,1429,605,10037,79.73,14.24,6.03
1907,2018,8059,1403,626,10088,79.89,13.91,6.21
1907,2019,8107,1357,642,10106,80.22,13.43,6.35
1907,2020,8107,1340,645,10092,80.33,13.28,6.39
1907,2021,8119,1322,658,10099,80.39,13.09,6.52
1907,2022,8094,1290,649,10033,80.67,12.86,6.47
1907,2023,8043,1257,634,9934,80.96,12.65,6.38
1960,2010,7134,698,257,8089,88.19,8.63,3.18
1960,2011,7127,693,266,8086,88.14,8.57,3.29
1960,2012,7025,684,321,8030,87.48,8.52,4.00
1960,2013,7045,702,428,8175,86.18,8.59,5.24
1960,2014,7052,697,520,8269,85.28,8.43,6.29
1960,2015,7010,692,641,8343,84.02,8.29,7.68
1960,2016,6984,694,754,8432,82.83,8.23,8.94
1960,2017,6991,686,926,8603,81.26,7.97,10.76
1960,2018,6976,706,985,8667,80.49,8.15,11.36
1960,2019,6962,695,1018,8675,80.25,8.01,11.73
1960,2020,7045,683,1017,8745,80.56,7.81,11.63
1960,2021,7125,681,981,8787,81.09,7.75,11.16
1960,2022,7124,665,973,8762,81.31,7.59,11.10
1960,2023,7015,655,973,8643,81.16,7.58,11.26
1961,2010,12580,1896,699,15175,82.90,12.49,4.61
1961,2011,12591,1881,752,15224,82.70,12.36,4.94
1961,2012,12598,1893,855,15346,82.09,12.34,5.57
1961,2013,12669,1888,967,15524,81.61,12.16,6.23
1961,2014,12710,1870,1016,15596,81.50,11.99,6.51
1961,2015,12692,1858,1095,15645,81.12,11.88,7.00
1961,2016,12837,1811,1195,15843,81.03,11.43,7.54
1961,2017,12932,1819,1247,15998,80.84,11.37,7.79
1961,2018,12980,1825,1381,16186,80.19,11.28,8.53
1961,2019,13085,1802,1459,16346,80.05,11.02,8.93
1961,2020,13147,1790,1463,16400,80.16,10.91,8.92
1961,2021,13339,1785,1484,16608,80.32,10.75,8.94
1961,2022,13416,1780,1515,16711,80.28,10.65,9.07
1961,2023,13380,1741,1533,16654,80.34,10.45,9.20
1962,2010,5169,403,151,5723,90.32,7.04,2.64
1962,2011,5165,387,173,5725,90.22,6.76,3.02
1962,2012,5065,383,182,5630,89.96,6.80,3.23
1962,2013,4969,384,255,5608,88.61,6.85,4.55
1962,2014,4957,363,399,5719,86.68,6.35,6.98
1962,2015,4966,372,465,5803,85.58,6.41,8.01
1962,2016,4910,369,516,5795,84.73,6.37,8.90
1962,2017,4902,364,530,5796,84.58,6.28,9.14
1962,2018,4896,352,547,5795,84.49,6.07,9.44
1962,2019,4836,339,515,5690,84.99,5.96,9.05
1962,2020,4857,344,528,5729,84.78,6.00,9.22
1962,2021,4852,348,514,5714,84.91,6.09,9.00
1962,2022,4819,341,467,5627,85.64,6.06,8.30
1962,2023,4755,334,428,5517,86.19,6.05,7.76
1980,2010,112476,11758,12973,137207,81.98,8.57,9.46
1980,2011,113400,11781,13528,138709,81.75,8.49,9.75
1980,2012,114518,11805,14176,140499,81.51,8.40,10.09
1980,2013,115199,11857,15075,142131,81.05,8.34,10.61
1980,2014,115746,11875,16081,143702,80.55,8.26,11.19
1980,2015,116517,11887,16814,145218,80.24,8.19,11.58
1980,2016,116943,11935,18542,147420,79.33,8.10,12.58
1980,2017,117868,11975,20291,150134,78.51,7.98,13.52
1980,2018,118388,11969,21721,152078,77.85,7.87,14.28
1980,2019,118926,11976,23147,154049,77.20,7.77,15.03
1980,2020,119422,11968,24161,155551,76.77,7.69,15.53
1980,2021,119610,12018,25210,156838,76.26,7.66,16.07
1980,2022,120141,12146,26366,158653,75.73,7.66,16.62
1980,2023,120243,12116,27303,159662,75.31,7.59,17.10
1981,2010,19602,1093,840,21535,91.02,5.08,3.90
1981,2011,19603,1106,859,21568,90.89,5.13,3.98
1981,2012,19558,1100,938,21596,90.56,5.09,4.34
1981,2013,19578,1124,1067,21769,89.94,5.16,4.90
1981,2014,19585,1168,1172,21925,89.33,5.33,5.35
1981,2015,19585,1191,1333,22109,88.58,5.39,6.03
1981,2016,19602,1179,1572,22353,87.69,5.27,7.03
1981,2017,19609,1197,1825,22631,86.65,5.29,8.06
1981,2018,19584,1228,2004,22816,85.83,5.38,8.78
1981,2019,19631,1196,2067,22894,85.75,5.22,9.03
1981,2020,19552,1174,2141,22867,85.50,5.13,9.36
1981,2021,19626,1164,2208,22998,85.34,5.06,9.60
1981,2022,19639,1144,2198,22981,85.46,4.98,9.56
1981,2023,19544,1148,2161,22853,85.52,5.02,9.46
1982,2010,10002,1647,794,12443,80.38,13.24,6.38
1982,2011,10030,1648,875,12553,79.90,13.13,6.97
1982,2012,10006,1636,992,12634,79.20,12.95,7.85
1982,2013,9996,1599,1277,12872,77.66,12.42,9.92
1982,2014,9973,1559,1601,13133,75.94,11.87,12.19
1982,2015,9972,1559,1755,13286,75.06,11.73,13.21
1982,2016,9930,1566,1949,13445,73.86,11.65,14.50
1982,2017,9925,1549,1941,13415,73.98,11.55,14.47
1982,2018,9914,1547,2003,13464,73.63,11.49,14.88
1982,2019,9859,1543,1989,13391,73.62,11.52,14.85
1982,2020,9796,1481,1990,13267,73.84,11.16,15.00
1982,2021,9761,1462,2096,13319,73.29,10.98,15.74
1982,2022,9684,1450,2207,13341,72.59,10.87,16.54
1982,2023,9564,1444,2214,13222,72.33,10.92,16.74
1983,2010,20811,2732,1362,24905,83.56,10.97,5.47
1983,2011,20623,2735,1449,24807,83.13,11.03,5.84
1983,2012,20563,2729,1562,24854,82.74,10.98,6.28
1983,2013,20596,2723,1918,25237,81.61,10.79,7.60
1983,2014,20556,2719,2101,25376,81.01,10.71,8.28
1983,2015,20551,2710,2296,25557,80.41,10.60,8.98
1983,2016,20648,2730,2572,25950,79.57,10.52,9.91
1983,2017,20644,2744,2728,26116,79.05,10.51,10.45
1983,2018,20619,2732,2917,26268,78.49,10.40,11.10
1983,2019,20554,2691,2969,26214,78.41,10.27,11.33
1983,2020,20444,2633,3008,26085,78.37,10.09,11.53
1983,2021,20480,2597,3056,26133,78.37,9.94,11.69
1983,2022,20457,2598,3065,26120,78.32,9.95,11.73
1983,2023,20404,2558,3016,25978,78.54,9.85,11.61
1984,2010,12025,798,462,13285,90.52,6.01,3.48
1984,2011,11994,809,499,13302,90.17,6.08,3.75
1984,2012,11978,817,558,13353,89.70,6.12,4.18
1984,2013,11981,824,688,13493,88.79,6.11,5.10
1984,2014,11958,829,844,13631,87.73,6.08,6.19
1984,2015,11944,849,1065,13858,86.19,6.13,7.69
1984,2016,11906,871,1126,13903,85.64,6.26,8.10
1984,2017,11897,883,1154,13934,85.38,6.34,8.28
1984,2018,12000,875,1263,14138,84.88,6.19,8.93
1984,2019,11954,846,1287,14087,84.86,6.01,9.14
1984,2020,11935,828,1276,14039,85.01,5.90,9.09
1984,2021,11958,836,1306,14100,84.81,5.93,9.26
1984,2022,11960,857,1266,14083,84.93,6.09,8.99
1984,2023,11916,867,1219,14002,85.10,6.19,8.71
2021,2010,6486,228,91,6805,95.31,3.35,1.34
2021,2011,6472,238,108,6818,94.93,3.49,1.58
2021,2012,6426,239,114,6779,94.79,3.53,1.68
2021,2013,6347,237,146,6730,94.31,3.52,2.17
2021,2014,6308,242,144,6694,94.23,3.62,2.15
2021,2015,6261,247,207,6715,93.24,3.68,3.08
2021,2016,6265,264,355,6884,91.01,3.83,5.16
2021,2017,6236,266,335,6837,91.21,3.89,4.90
2021,2018,6237,273,297,6807,91.63,4.01,4.36
2021,2019,6219,291,295,6805,91.39,4.28,4.34
2021,2020,6185,297,319,6801,90.94,4.37,4.69
2021,2021,6139,317,320,6776,90.60,4.68,4.72
2021,2022,6126,336,338,6800,90.09,4.94,4.97
2021,2023,6049,349,330,6728,89.91,5.19,4.90
2023,2010,9526,562,268,10356,91.99,5.43,2.59
2023,2011,9441,556,265,10262,92.00,5.42,2.58
2023,2012,9303,591,284,10178,91.40,5.81,2.79
2023,2013,9186,580,295,10061,91.30,5.76,2.93
2023,2014,9075,577,317,9969,91.03,5.79,3.18
2023,2015,9080,583,373,10036,90.47,5.81,3.72
2023,2016,8987,602,502,10091,89.06,5.97,4.97
2023,2017,8986,589,539,10114,88.85,5.82,5.33
2023,2018,8960,616,530,10106,88.66,6.10,5.24
2023,2019,8940,635,563,10138,88.18,6.26,5.55
2023,2020,8947,645,585,10177,87.91,6.34,5.75
2023,2021,8972,646,600,10218,87.81,6.32,5.87
2023,2022,8984,672,602,10258,87.58,6.55,5.87
2023,2023,8994,703,563,10260,87.66,6.85,5.49
2026,2010,9525,390,182,10097,94.33,3.86,1.80
2026,2011,9499,378,192,10069,94.34,3.75,1.91
2026,2012,9427,375,210,10012,94.16,3.75,2.10
2026,2013,9434,372,217,10023,94.12,3.71,2.17
2026,2014,9409,381,234,10024,93.86,3.80,2.33
2026,2015,9438,386,255,10079,93.64,3.83,2.53
2026,2016,9494,398,283,10175,93.31,3.91,2.78
2026,2017,9534,422,285,10241,93.10,4.12,2.78
2026,2018,9510,423,338,10271,92.59,4.12,3.29
2026,2019,9525,428,351,10304,92.44,4.15,3.41
2026,2020,9613,421,344,10378,92.63,4.06,3.31
2026,2021,9754,435,313,10502,92.88,4.14,2.98
2026,2022,9739,422,338,10499,92.76,4.02,3.22
2026,2023,9720,411,299,10430,93.19,3.94,2.87
2029,2010,14396,568,325,15289,94.16,3.72,2.13
2029,2011,14326,556,356,15238,94.01,3.65,2.34
2029,2012,14191,584,371,15146,93.69,3.86,2.45
2029,2013,14135,610,412,15157,93.26,4.02,2.72
2029,2014,14160,619,473,15252,92.84,4.06,3.10
2029,2015,14184,619,523,15326,92.55,4.04,3.41
2029,2016,14160,644,703,15507,91.31,4.15,4.53
2029,2017,14268,655,717,15640,91.23,4.19,4.58
2029,2018,14331,671,802,15804,90.68,4.25,5.07
2029,2019,14323,680,804,15807,90.61,4.30,5.09
2029,2020,14329,683,789,15801,90.68,4.32,4.99
2029,2021,14517,698,797,16012,90.66,4.36,4.98
2029,2022,14611,709,793,16113,90.68,4.40,4.92
2029,2023,14525,725,793,16043,90.54,4.52,4.94
2031,2010,10298,367,146,10811,95.25,3.39,1.35
2031,2011,10319,384,156,10859,95.03,3.54,1.44
2031,2012,10251,384,164,10799,94.93,3.56,1.52
2031,2013,10202,387,177,10766,94.76,3.59,1.64
2031,2014,10170,399,179,10748,94.62,3.71,1.67
2031,2015,10126,412,221,10759,94.12,3.83,2.05
2031,2016,10117,428,311,10856,93.19,3.94,2.86
2031,2017,10110,432,295,10837,93.29,3.99,2.72
2031,2018,10142,447,318,10907,92.99,4.10,2.92
2031,2019,10176,444,330,10950,92.93,4.05,3.01
2031,2020,10234,474,339,11047,92.64,4.29,3.07
2031,2021,10249,482,372,11103,92.31,4.34,3.35
2031,2022,10231,486,375,11092,92.24,4.38,3.38
2031,2023,10184,495,363,11042,92.23,4.48,3.29
2034,2010,6411,293,218,6922,92.62,4.23,3.15
2034,2011,6341,292,234,6867,92.34,4.25,3.41
2034,2012,6298,294,243,6835,92.14,4.30,3.56
2034,2013,6278,292,279,6849,91.66,4.26,4.07
2034,2014,6201,295,316,6812,91.03,4.33,4.64
2034,2015,6085,296,369,6750,90.15,4.39,5.47
2034,2016,6074,293,494,6861,88.53,4.27,7.20
2034,2017,6046,286,555,6887,87.79,4.15,8.06
2034,2018,6037,296,559,6892,87.59,4.29,8.11
2034,2019,6041,309,561,6911,87.41,4.47,8.12
2034,2020,6027,321,529,6877,87.64,4.67,7.69
2034,2021,6082,328,508,6918,87.92,4.74,7.34
2034,2022,6089,344,501,6934,87.81,4.96,7.23
2034,2023,6086,350,472,6908,88.10,5.07,6.83
2039,2010,6816,303,88,7207,94.57,4.20,1.22
2039,2011,6754,319,111,7184,94.01,4.44,1.55
2039,2012,6691,326,122,7139,93.72,4.57,1.71
2039,2013,6641,316,139,7096,93.59,4.45,1.96
2039,2014,6574,308,170,7052,93.22,4.37,2.41
2039,2015,6516,323,196,7035,92.62,4.59,2.79
2039,2016,6479,322,238,7039,92.04,4.57,3.38
2039,2017,6479,326,263,7068,91.67,4.61,3.72
2039,2018,6481,333,307,7121,91.01,4.68,4.31
2039,2019,6391,334,306,7031,90.90,4.75,4.35
2039,2020,6397,335,301,7033,90.96,4.76,4.28
2039,2021,6400,338,304,7042,90.88,4.80,4.32
2039,2022,6343,364,311,7018,90.38,5.19,4.43
2039,2023,6283,366,280,6929,90.68,5.28,4.04
2061,2010,9726,710,279,10715,90.77,6.63,2.60
2061,2011,9670,699,293,10662,90.70,6.56,2.75
2061,2012,9641,684,325,10650,90.53,6.42,3.05
2061,2013,9635,684,372,10691,90.12,6.40,3.48
2061,2014,9596,695,421,10712,89.58,6.49,3.93
2061,2015,9635,704,451,10790,89.30,6.52,4.18
2061,2016,9656,692,561,10909,88.51,6.34,5.14
2061,2017,9655,689,550,10894,88.63,6.32,5.05
2061,2018,9635,695,567,10897,88.42,6.38,5.20
2061,2019,9659,687,548,10894,88.66,6.31,5.03
2061,2020,9668,678,508,10854,89.07,6.25,4.68
2061,2021,9763,668,502,10933,89.30,6.11,4.59
2061,2022,9796,653,473,10922,89.69,5.98,4.33
2061,2023,9795,662,456,10913,89.76,6.07,4.18
2062,2010,19014,800,339,20153,94.35,3.97,1.68
2062,2011,18936,822,349,20107,94.18,4.09,1.74
2062,2012,18851,875,356,20082,93.87,4.36,1.77
2062,2013,18756,843,399,19998,93.79,4.22,2.00
2062,2014,18713,877,416,20006,93.54,4.38,2.08
2062,2015,18700,893,508,20101,93.03,4.44,2.53
2062,2016,18749,913,617,20279,92.46,4.50,3.04
2062,2017,18749,921,699,20369,92.05,4.52,3.43
2062,2018,18711,934,745,20390,91.77,4.58,3.65
2062,2019,18731,924,815,20470,91.50,4.51,3.98
2062,2020,18722,929,841,20492,91.36,4.53,4.10
2062,2021,18834,952,884,20670,91.12,4.61,4.28
2062,2022,18795,979,905,20679,90.89,4.73,4.38
2062,2023,18658,984,894,20536,90.86,4.79,4.35
2080,2010,51571,2346,2127,56044,92.02,4.19,3.80
2080,2011,51551,2338,2235,56124,91.85,4.17,3.98
2080,2012,51698,2348,2386,56432,91.61,4.16,4.23
2080,2013,51875,2376,2516,56767,91.38,4.19,4.43
2080,2014,51850,2399,2647,56896,91.13,4.22,4.65
2080,2015,51856,2411,2795,57062,90.88,4.23,4.90
2080,2016,52092,2423,3170,57685,90.30,4.20,5.50
2080,2017,52306,2475,3559,58340,89.66,4.24,6.10
2080,2018,52636,2501,3786,58923,89.33,4.24,6.43
2080,2019,52938,2536,3932,59406,89.11,4.27,6.62
2080,2020,53096,2526,3906,59528,89.20,4.24,6.56
2080,2021,53335,2563,3939,59837,89.13,4.28,6.58
2080,2022,53398,2561,3859,59818,89.27,4.28,6.45
2080,2023,53524,2596,3866,59986,89.23,4.33,6.44
2081,2010,42661,2730,3860,49251,86.62,5.54,7.84
2081,2011,42749,2709,3865,49323,86.67,5.49,7.84
2081,2012,42755,2715,4012,49482,86.41,5.49,8.11
2081,2013,42778,2697,4548,50023,85.52,5.39,9.09
2081,2014,42866,2702,5147,50715,84.52,5.33,10.15
2081,2015,42723,2727,5538,50988,83.79,5.35,10.86
2081,2016,42767,2728,6109,51604,82.88,5.29,11.84
2081,2017,42760,2688,6516,51964,82.29,5.17,12.54
2081,2018,42805,2663,6756,52224,81.96,5.10,12.94
2081,2019,42946,2643,7001,52590,81.66,5.03,13.31
2081,2020,42795,2638,6961,52394,81.68,5.03,13.29
2081,2021,42675,2603,6976,52254,81.67,4.98,13.35
2081,2022,42647,2579,6952,52178,81.73,4.94,13.32
2081,2023,42324,2578,6833,51735,81.81,4.98,13.21
2082,2010,10259,346,235,10840,94.64,3.19,2.17
2082,2011,10250,346,265,10861,94.37,3.19,2.44
2082,2012,10203,347,301,10851,94.03,3.20,2.77
2082,2013,10178,357,338,10873,93.61,3.28,3.11
2082,2014,10190,338,358,10886,93.61,3.10,3.29
2082,2015,10262,369,378,11009,93.21,3.35,3.43
2082,2016,10322,363,401,11086,93.11,3.27,3.62
2082,2017,10355,358,447,11160,92.79,3.21,4.01
2082,2018,10319,360,444,11123,92.77,3.24,3.99
2082,2019,10239,382,472,11093,92.30,3.44,4.25
2082,2020,10288,370,503,11161,92.18,3.32,4.51
2082,2021,10340,382,520,11242,91.98,3.40,4.63
2082,2022,10326,402,543,11271,91.62,3.57,4.82
2082,2023,10331,385,527,11243,91.89,3.42,4.69
2083,2010,13850,919,395,15164,91.33,6.06,2.60
2083,2011,13741,950,428,15119,90.89,6.28,2.83
2083,2012,13579,952,533,15064,90.14,6.32,3.54
2083,2013,13499,948,574,15021,89.87,6.31,3.82
2083,2014,13398,946,741,15085,88.82,6.27,4.91
2083,2015,13332,927,976,15235,87.51,6.08,6.41
2083,2016,13275,922,1264,15461,85.86,5.96,8.18
2083,2017,13237,967,1362,15566,85.04,6.21,8.75
2083,2018,13182,972,1303,15457,85.28,6.29,8.43
2083,2019,13183,947,1361,15491,85.10,6.11,8.79
2083,2020,13179,958,1325,15462,85.23,6.20,8.57
2083,2021,13176,960,1322,15458,85.24,6.21,8.55
2083,2022,13204,967,1272,15443,85.50,6.26,8.24
2083,2023,13169,970,1206,15345,85.82,6.32,7.86
2084,2010,19380,1425,778,21583,89.79,6.60,3.60
2084,2011,19288,1407,791,21486,89.77,6.55,3.68
2084,2012,19167,1422,878,21467,89.29,6.62,4.09
2084,2013,19019,1393,1170,21582,88.12,6.45,5.42
2084,2014,19029,1420,1573,22022,86.41,6.45,7.14
2084,2015,19029,1424,2328,22781,83.53,6.25,10.22
2084,2016,18981,1448,2732,23161,81.95,6.25,11.80
2084,2017,18989,1453,2814,23256,81.65,6.25,12.10
2084,2018,19023,1469,2831,23323,81.56,6.30,12.14
2084,2019,18903,1447,2828,23178,81.56,6.24,12.20
2084,2020,18888,1415,2764,23067,81.88,6.13,11.98
2084,2021,18909,1385,2631,22925,82.48,6.04,11.48
2084,2022,18980,1384,2568,22932,82.77,6.04,11.20
2084,2023,18915,1341,2497,22753,83.13,5.89,10.97
2085,2010,22877,1579,1354,25810,88.64,6.12,5.25
2085,2011,22678,1560,1348,25586,88.63,6.10,5.27
2085,2012,22592,1542,1505,25639,88.12,6.01,5.87
2085,2013,22480,1554,1678,25712,87.43,6.04,6.53
2085,2014,22450,1552,2028,26030,86.25,5.96,7.79
2085,2015,22303,1559,2500,26362,84.60,5.91,9.48
2085,2016,22269,1521,3143,26933,82.68,5.65,11.67
2085,2017,22228,1504,3260,26992,82.35,5.57,12.08
2085,2018,22019,1488,3439,26946,81.72,5.52,12.76
2085,2019,21926,1461,3511,26898,81.52,5.43,13.05
2085,2020,21751,1462,3391,26604,81.76,5.50,12.75
2085,2021,21680,1443,3374,26497,81.82,5.45,12.73
2085,2022,21522,1460,3371,26353,81.67,5.54,12.79
2085,2023,21397,1477,3528,26402,81.04,5.59,13.36
2101,2010,5531,202,203,5936,93.18,3.40,3.42
2101,2011,5462,210,235,5907,92.47,3.56,3.98
2101,2012,5386,208,256,5850,92.07,3.56,4.38
2101,2013,5290,208,287,5785,91.44,3.60,4.96
2101,2014,5218,212,335,5765,90.51,3.68,5.81
2101,2015,5160,219,470,5849,88.22,3.74,8.04
2101,2016,5099,220,537,5856,87.07,3.76,9.17
2101,2017,5086,230,580,5896,86.26,3.90,9.84
2101,2018,5081,232,593,5906,86.03,3.93,10.04
2101,2019,5097,234,577,5908,86.27,3.96,9.77
2101,2020,5096,236,552,5884,86.61,4.01,9.38
2101,2021,5098,236,531,5865,86.92,4.02,9.05
2101,2022,5068,254,499,5821,87.06,4.36,8.57
2101,2023,5060,249,449,5758,87.88,4.32,7.80
2104,2010,8561,773,407,9741,87.89,7.94,4.18
2104,2011,8436,738,404,9578,88.08,7.71,4.22
2104,2012,8352,735,434,9521,87.72,7.72,4.56
2104,2013,8330,712,469,9511,87.58,7.49,4.93
2104,2014,8206,704,521,9431,87.01,7.46,5.52
2104,2015,8163,688,584,9435,86.52,7.29,6.19
2104,2016,8189,670,705,9564,85.62,7.01,7.37
2104,2017,8211,682,767,9660,85.00,7.06,7.94
2104,2018,8153,679,770,9602,84.91,7.07,8.02
2104,2019,8144,671,773,9588,84.94,7.00,8.06
2104,2020,8126,652,792,9570,84.91,6.81,8.28
2104,2021,8143,647,788,9578,85.02,6.76,8.23
2104,2022,8095,646,731,9472,85.46,6.82,7.72
2104,2023,8051,626,697,9374,85.89,6.68,7.44
2121,2010,10977,258,205,11440,95.95,2.26,1.79
2121,2011,10913,261,230,11404,95.69,2.29,2.02
2121,2012,10883,251,258,11392,95.53,2.20,2.26
2121,2013,10778,247,329,11354,94.93,2.18,2.90
2121,2014,10689,262,481,11432,93.50,2.29,4.21
2121,2015,10580,245,644,11469,92.25,2.14,5.62
2121,2016,10604,261,766,11631,91.17,2.24,6.59
2121,2017,10599,256,754,11609,91.30,2.21,6.49
2121,2018,10592,258,834,11684,90.65,2.21,7.14
2121,2019,10565,245,860,11670,90.53,2.10,7.37
2121,2020,10578,256,838,11672,90.63,2.19,7.18
2121,2021,10637,250,824,11711,90.83,2.13,7.04
2121,2022,10590,250,782,11622,91.12,2.15,6.73
2121,2023,10549,254,722,11525,91.53,2.20,6.26
2132,2010,9045,316,250,9611,94.11,3.29,2.60
2132,2011,8914,323,296,9533,93.51,3.39,3.11
2132,2012,8861,333,339,9533,92.95,3.49,3.56
2132,2013,8795,342,354,9491,92.67,3.60,3.73
2132,2014,8729,359,405,9493,91.95,3.78,4.27
2132,2015,8691,353,446,9490,91.58,3.72,4.70
2132,2016,8666,352,493,9511,91.12,3.70,5.18
2132,2017,8636,360,485,9481,91.09,3.80,5.12
2132,2018,8637,355,525,9517,90.75,3.73,5.52
2132,2019,8608,377,492,9477,90.83,3.98,5.19
2132,2020,8626,378,479,9483,90.96,3.99,5.05
2132,2021,8626,385,469,9480,90.99,4.06,4.95
2132,2022,8618,402,467,9487,90.84,4.24,4.92
2132,2023,8517,414,439,9370,90.90,4.42,4.69
2161,2010,17817,691,557,19065,93.45,3.62,2.92
2161,2011,17687,642,645,18974,93.22,3.38,3.40
2161,2012,17494,629,757,18880,92.66,3.33,4.01
2161,2013,17383,614,934,18931,91.82,3.24,4.93
2161,2014,17248,629,1072,18949,91.02,3.32,5.66
2161,2015,17157,648,1222,19027,90.17,3.41,6.42
2161,2016,17103,605,1359,19067,89.70,3.17,7.13
2161,2017,17015,624,1389,19028,89.42,3.28,7.30
2161,2018,16986,634,1413,19033,89.24,3.33,7.42
2161,2019,16957,603,1389,18949,89.49,3.18,7.33
2161,2020,16921,599,1347,18867,89.69,3.17,7.14
2161,2021,16897,615,1292,18804,89.86,3.27,6.87
2161,2022,16902,623,1246,18771,90.04,3.32,6.64
2161,2023,16713,629,1196,18538,90.16,3.39,6.45
2180,2010,84292,4224,6539,95055,88.68,4.44,6.88
2180,2011,84557,4284,6587,95428,88.61,4.49,6.90
2180,2012,84775,4325,7070,96170,88.15,4.50,7.35
2180,2013,84899,4349,7988,97236,87.31,4.47,8.22
2180,2014,84985,4351,8978,98314,86.44,4.43,9.13
2180,2015,85235,4383,9259,98877,86.20,4.43,9.36
2180,2016,85472,4413,9903,99788,85.65,4.42,9.92
2180,2017,85718,4421,10464,100603,85.20,4.39,10.40
2180,2018,86117,4405,10933,101455,84.88,4.34,10.78
2180,2019,86383,4461,11574,102418,84.34,4.36,11.30
2180,2020,86510,4492,11902,102904,84.07,4.37,11.57
2180,2021,86374,4666,12096,103136,83.75,4.52,11.73
2180,2022,86520,4738,12235,103493,83.60,4.58,11.82
2180,2023,86414,4815,12303,103532,83.47,4.65,11.88
2181,2010,33081,1693,2142,36916,89.61,4.59,5.80
2181,2011,32908,1724,2363,36995,88.95,4.66,6.39
2181,2012,32811,1740,2538,37089,88.47,4.69,6.84
2181,2013,32637,1748,2865,37250,87.62,4.69,7.69
2181,2014,32718,1742,3373,37833,86.48,4.60,8.92
2181,2015,32580,1727,4007,38314,85.03,4.51,10.46
2181,2016,32556,1722,4671,38949,83.59,4.42,11.99
2181,2017,32493,1710,5056,39259,82.77,4.36,12.88
2181,2018,32350,1690,5168,39208,82.51,4.31,13.18
2181,2019,32251,1669,5314,39234,82.20,4.25,13.54
2181,2020,32254,1677,5359,39290,82.09,4.27,13.64
2181,2021,32165,1732,5353,39250,81.95,4.41,13.64
2181,2022,31937,1776,5385,39098,81.68,4.54,13.77
2181,2023,31660,1818,5150,38628,81.96,4.71,13.33
2182,2010,23794,946,907,25647,92.77,3.69,3.54
2182,2011,23459,924,951,25334,92.60,3.65,3.75
2182,2012,23256,938,1029,25223,92.20,3.72,4.08
2182,2013,23159,938,1345,25442,91.03,3.69,5.29
2182,2014,22967,938,1551,25456,90.22,3.68,6.09
2182,2015,22931,955,1899,25785,88.93,3.70,7.36
2182,2016,22731,975,2286,25992,87.45,3.75,8.80
2182,2017,22535,956,2291,25782,87.41,3.71,8.89
2182,2018,22422,967,2332,25721,87.17,3.76,9.07
2182,2019,22268,943,2432,25643,86.84,3.68,9.48
2182,2020,22135,942,2415,25492,86.83,3.70,9.47
2182,2021,22101,959,2386,25446,86.85,3.77,9.38
2182,2022,21935,965,2358,25258,86.84,3.82,9.34
2182,2023,21682,969,2207,24858,87.22,3.90,8.88
2183,2010,24563,772,913,26248,93.58,2.94,3.48
2183,2011,24470,765,958,26193,93.42,2.92,3.66
2183,2012,24344,769,1045,26158,93.07,2.94,3.99
2183,2013,24107,802,1232,26141,92.22,3.07,4.71
2183,2014,23991,835,1568,26394,90.90,3.16,5.94
2183,2015,23833,816,1945,26594,89.62,3.07,7.31
2183,2016,23819,836,2274,26929,88.45,3.10,8.44
2183,2017,23688,824,2406,26918,88.00,3.06,8.94
2183,2018,23744,826,2421,26991,87.97,3.06,8.97
2183,2019,23690,818,2380,26888,88.11,3.04,8.85
2183,2020,23677,808,2324,26809,88.32,3.01,8.67
2183,2021,23655,811,2287,26753,88.42,3.03,8.55
2183,2022,23541,824,2259,26624,88.42,3.09,8.48
2183,2023,23429,815,2170,26414,88.70,3.09,8.22
2184,2010,34404,1283,1162,36849,93.36,3.48,3.15
2184,2011,34250,1301,1233,36784,93.11,3.54,3.35
2184,2012,34167,1313,1341,36821,92.79,3.57,3.64
2184,2013,34017,1349,1463,36829,92.36,3.66,3.97
2184,2014,33946,1365,1613,36924,91.93,3.70,4.37
2184,2015,33925,1359,1691,36975,91.75,3.68,4.57
2184,2016,33959,1383,1957,37299,91.05,3.71,5.25
2184,2017,33994,1384,2023,37401,90.89,3.70,5.41
2184,2018,33865,1405,2160,37430,90.48,3.75,5.77
2184,2019,33916,1402,2289,37607,90.19,3.73,6.09
2184,2020,33805,1410,2316,37531,90.07,3.76,6.17
2184,2021,33952,1441,2351,37744,89.95,3.82,6.23
2184,2022,33893,1465,2330,37688,89.93,3.89,6.18
2184,2023,33833,1500,2312,37645,89.87,3.98,6.14
2260,2010,9487,352,214,10053,94.37,3.50,2.13
2260,2011,9265,357,217,9839,94.17,3.63,2.21
2260,2012,9047,371,221,9639,93.86,3.85,2.29
2260,2013,8927,367,254,9548,93.50,3.84,2.66
2260,2014,8830,366,288,9484,93.10,3.86,3.04
2260,2015,8807,368,318,9493,92.77,3.88,3.35
2260,2016,8719,374,402,9495,91.83,3.94,4.23
2260,2017,8664,377,439,9480,91.39,3.98,4.63
2260,2018,8588,388,435,9411,91.25,4.12,4.62
2260,2019,8524,395,397,9316,91.50,4.24,4.26
2260,2020,8481,390,355,9226,91.92,4.23,3.85
2260,2021,8476,403,354,9233,91.80,4.36,3.83
2260,2022,8393,415,335,9143,91.80,4.54,3.66
2260,2023,8369,416,324,9109,91.88,4.57,3.56
2262,2010,16593,712,685,17990,92.23,3.96,3.81
2262,2011,16546,699,781,18026,91.79,3.88,4.33
2262,2012,16467,687,843,17997,91.50,3.82,4.68
2262,2013,16446,705,911,18062,91.05,3.90,5.04
2262,2014,16413,689,923,18025,91.06,3.82,5.12
2262,2015,16338,688,961,17987,90.83,3.82,5.34
2262,2016,16283,695,1014,17992,90.50,3.86,5.64
2262,2017,16267,689,1074,18030,90.22,3.82,5.96
2262,2018,16287,684,1089,18060,90.18,3.79,6.03
2262,2019,16219,684,1076,17979,90.21,3.80,5.98
2262,2020,16155,681,1127,17963,89.93,3.79,6.27
2262,2021,16109,690,1124,17923,89.88,3.85,6.27
2262,2022,15927,701,1126,17754,89.71,3.95,6.34
2262,2023,15792,679,1069,17540,90.03,3.87,6.09
2280,2010,22674,836,1101,24611,92.13,3.40,4.47
2280,2011,22516,849,1176,24541,91.75,3.46,4.79
2280,2012,22292,862,1244,24398,91.37,3.53,5.10
2280,2013,22123,867,1519,24509,90.26,3.54,6.20
2280,2014,22009,886,1860,24755,88.91,3.58,7.51
2280,2015,21856,938,2272,25066,87.19,3.74,9.06
2280,2016,21712,935,2622,25269,85.92,3.70,10.38
2280,2017,21493,946,2751,25190,85.32,3.76,10.92
2280,2018,21410,954,2756,25120,85.23,3.80,10.97
2280,2019,21440,960,2783,25183,85.14,3.81,11.05
2280,2020,21425,965,2724,25114,85.31,3.84,10.85
2280,2021,21337,988,2687,25012,85.31,3.95,10.74
2280,2022,21169,1018,2692,24879,85.09,4.09,10.82
2280,2023,21031,1029,2594,24654,85.30,4.17,10.52
2281,2010,87765,3579,4388,95732,91.68,3.74,4.58
2281,2011,87883,3627,4603,96113,91.44,3.77,4.79
2281,2012,88059,3700,4928,96687,91.08,3.83,5.10
2281,2013,87928,3739,5311,96978,90.67,3.86,5.48
2281,2014,87857,3795,5686,97338,90.26,3.90,5.84
2281,2015,87862,3875,5896,97633,89.99,3.97,6.04
2281,2016,87987,3995,6343,98325,89.49,4.06,6.45
2281,2017,88097,3992,6721,98810,89.16,4.04,6.80
2281,2018,87875,4002,6973,98850,88.90,4.05,7.05
2281,2019,88077,3987,7385,99449,88.56,4.01,7.43
2281,2020,87950,3959,7530,99439,88.45,3.98,7.57
2281,2021,87758,3936,7689,99383,88.30,3.96,7.74
2281,2022,87626,3980,7755,99361,88.19,4.01,7.80
2281,2023,87439,4040,7734,99213,88.13,4.07,7.80
2282,2010,17610,862,439,18911,93.12,4.56,2.32
2282,2011,17363,901,478,18742,92.64,4.81,2.55
2282,2012,17099,910,507,18516,92.35,4.91,2.74
2282,2013,16857,909,684,18450,91.37,4.93,3.71
2282,2014,16677,948,810,18435,90.46,5.14,4.39
2282,2015,16432,944,983,18359,89.50,5.14,5.35
2282,2016,16367,976,1338,18681,87.61,5.22,7.16
2282,2017,16254,1002,1354,18610,87.34,5.38,7.28
2282,2018,16017,1008,1398,18423,86.94,5.47,7.59
2282,2019,15838,1006,1438,18282,86.63,5.50,7.87
2282,2020,15716,1031,1386,18133,86.67,5.69,7.64
2282,2021,15675,1049,1281,18005,87.06,5.83,7.11
2282,2022,15558,1138,1208,17904,86.90,6.36,6.75
2282,2023,15299,1208,1124,17631,86.77,6.85,6.38
2283,2010,18875,712,668,20255,93.19,3.52,3.30
2283,2011,18538,712,714,19964,92.86,3.57,3.58
2283,2012,18221,723,792,19736,92.32,3.66,4.01
2283,2013,17968,713,942,19623,91.57,3.63,4.80
2283,2014,17861,755,1160,19776,90.32,3.82,5.87
2283,2015,17650,778,1355,19783,89.22,3.93,6.85
2283,2016,17416,822,1608,19846,87.76,4.14,8.10
2283,2017,17180,823,1706,19709,87.17,4.18,8.66
2283,2018,17003,831,1666,19500,87.19,4.26,8.54
2283,2019,16822,826,1492,19140,87.89,4.32,7.80
2283,2020,16646,826,1400,18872,88.20,4.38,7.42
2283,2021,16570,873,1371,18814,88.07,4.64,7.29
2283,2022,16415,953,1299,18667,87.94,5.11,6.96
2283,2023,16271,986,1266,18523,87.84,5.32,6.83
2284,2010,51754,1588,1731,55073,93.97,2.88,3.14
2284,2011,51528,1585,1817,54930,93.81,2.89,3.31
2284,2012,51488,1589,1931,55008,93.60,2.89,3.51
2284,2013,51363,1553,2070,54986,93.41,2.82,3.76
2284,2014,51399,1555,2294,55248,93.03,2.81,4.15
2284,2015,51294,1617,2665,55576,92.30,2.91,4.80
2284,2016,51221,1665,3078,55964,91.52,2.98,5.50
2284,2017,51003,1712,3424,56139,90.85,3.05,6.10
2284,2018,50866,1727,3496,56089,90.69,3.08,6.23
2284,2019,50636,1728,3634,55998,90.42,3.09,6.49
2284,2020,50490,1755,3562,55807,90.47,3.14,6.38
2284,2021,50525,1798,3500,55823,90.51,3.22,6.27
2284,2022,50276,1851,3430,55557,90.49,3.33,6.17
2284,2023,50201,1919,3358,55478,90.49,3.46,6.05
2303,2010,5228,249,113,5590,93.52,4.45,2.02
2303,2011,5135,240,126,5501,93.35,4.36,2.29
2303,2012,5046,254,166,5466,92.32,4.65,3.04
2303,2013,4972,267,219,5458,91.10,4.89,4.01
2303,2014,4914,277,249,5440,90.33,5.09,4.58
2303,2015,4830,270,287,5387,89.66,5.01,5.33
2303,2016,4752,270,393,5415,87.76,4.99,7.26
2303,2017,4719,291,434,5444,86.68,5.35,7.97
2303,2018,4689,285,369,5343,87.76,5.33,6.91
2303,2019,4662,281,341,5284,88.23,5.32,6.45
2303,2020,4628,281,299,5208,88.86,5.40,5.74
2303,2021,4605,302,303,5210,88.39,5.80,5.82
2303,2022,4558,329,287,5174,88.09,6.36,5.55
2303,2023,4546,329,260,5135,88.53,6.41,5.06
2305,2010,6331,280,274,6885,91.95,4.07,3.98
2305,2011,6173,283,294,6750,91.45,4.19,4.36
2305,2012,6028,290,337,6655,90.58,4.36,5.06
2305,2013,5930,279,350,6559,90.41,4.25,5.34
2305,2014,5793,284,386,6463,89.63,4.39,5.97
2305,2015,5715,290,450,6455,88.54,4.49,6.97
2305,2016,5675,312,505,6492,87.42,4.81,7.78
2305,2017,5660,307,534,6501,87.06,4.72,8.21
2305,2018,5594,320,462,6376,87.74,5.02,7.25
2305,2019,5554,321,423,6298,88.19,5.10,6.72
2305,2020,5469,330,382,6181,88.48,5.34,6.18
2305,2021,5462,334,379,6175,88.45,5.41,6.14
2305,2022,5427,365,370,6162,88.07,5.92,6.00
2305,2023,5361,385,353,6099,87.90,6.31,5.79
2309,2010,13769,481,285,14535,94.73,3.31,1.96
2309,2011,13764,500,295,14559,94.54,3.43,2.03
2309,2012,13756,510,324,14590,94.28,3.50,2.22
2309,2013,13685,511,447,14643,93.46,3.49,3.05
2309,2014,13704,519,425,14648,93.56,3.54,2.90
2309,2015,13725,528,532,14785,92.83,3.57,3.60
2309,2016,13696,536,611,14843,92.27,3.61,4.12
2309,2017,13721,532,672,14925,91.93,3.56,4.50
2309,2018,13702,521,635,14858,92.22,3.51,4.27
2309,2019,13808,535,623,14966,92.26,3.57,4.16
2309,2020,13904,545,605,15054,92.36,3.62,4.02
2309,2021,14205,562,585,15352,92.53,3.66,3.81
2309,2022,14384,587,561,15532,92.61,3.78,3.61
2309,2023,14461,589,545,15595,92.73,3.78,3.49
2313,2010,11257,509,419,12185,92.38,4.18,3.44
2313,2011,11123,522,526,12171,91.39,4.29,4.32
2313,2012,11014,542,582,12138,90.74,4.47,4.79
2313,2013,10833,530,621,11984,90.40,4.42,5.18
2313,2014,10680,560,633,11873,89.95,4.72,5.33
2313,2015,10523,557,632,11712,89.85,4.76,5.40
2313,2016,10441,565,803,11809,88.42,4.78,6.80
2313,2017,10372,586,833,11791,87.97,4.97,7.06
2313,2018,10310,591,802,11703,88.10,5.05,6.85
2313,2019,10203,585,817,11605,87.92,5.04,7.04
2313,2020,10128,580,780,11488,88.16,5.05,6.79
2313,2021,10095,611,767,11473,87.99,5.33,6.69
2313,2022,10026,640,731,11397,87.97,5.62,6.41
2313,2023,9815,664,634,11113,88.32,5.97,5.71
2321,2010,9606,481,187,10274,93.50,4.68,1.82
2321,2011,9563,471,225,10259,93.22,4.59,2.19
2321,2012,9651,489,266,10406,92.74,4.70,2.56
2321,2013,9579,505,336,10420,91.93,4.85,3.22
2321,2014,9610,517,428,10555,91.05,4.90,4.05
2321,2015,9603,525,549,10677,89.94,4.92,5.14
2321,2016,9743,554,791,11088,87.87,5.00,7.13
2321,2017,9805,581,882,11268,87.02,5.16,7.83
2321,2018,10016,588,925,11529,86.88,5.10,8.02
2321,2019,10212,579,936,11727,87.08,4.94,7.98
2321,2020,10514,604,931,12049,87.26,5.01,7.73
2321,2021,10778,626,867,12271,87.83,5.10,7.07
2321,2022,10873,652,805,12330,88.18,5.29,6.53
2321,2023,11012,678,774,12464,88.35,5.44,6.21
2326,2010,6979,225,148,7352,94.93,3.06,2.01
2326,2011,6912,249,184,7345,94.10,3.39,2.51
2326,2012,6792,235,188,7215,94.14,3.26,2.61
2326,2013,6682,227,251,7160,93.32,3.17,3.51
2326,2014,6569,233,265,7067,92.95,3.30,3.75
2326,2015,6502,242,288,7032,92.46,3.44,4.10
2326,2016,6430,261,390,7081,90.81,3.69,5.51
2326,2017,6447,266,409,7122,90.52,3.73,5.74
2326,2018,6470,254,373,7097,91.17,3.58,5.26
2326,2019,6453,269,339,7061,91.39,3.81,4.80
2326,2020,6510,256,354,7120,91.43,3.60,4.97
2326,2021,6515,258,362,7135,91.31,3.62,5.07
2326,2022,6526,279,371,7176,90.94,3.89,5.17
2326,2023,6478,300,362,7140,90.73,4.20,5.07
2361,2010,9753,477,224,10454,93.29,4.56,2.14
2361,2011,9624,469,248,10341,93.07,4.54,2.40
2361,2012,9502,465,279,10246,92.74,4.54,2.72
2361,2013,9390,488,403,10281,91.33,4.75,3.92
2361,2014,9326,479,419,10224,91.22,4.69,4.10
2361,2015,9287,489,486,10262,90.50,4.77,4.74
2361,2016,9154,483,563,10200,89.75,4.74,5.52
2361,2017,9020,521,613,10154,88.83,5.13,6.04
2361,2018,8998,550,599,10147,88.68,5.42,5.90
2361,2019,8953,570,567,10090,88.73,5.65,5.62
2361,2020,8945,571,554,10070,88.83,5.67,5.50
2361,2021,8971,602,541,10114,88.70,5.95,5.35
2361,2022,9044,620,521,10185,88.80,6.09,5.12
2361,2023,9004,632,509,10145,88.75,6.23,5.02
2380,2010,55771,1771,1874,59416,93.87,2.98,3.15
2380,2011,55682,1797,1894,59373,93.78,3.03,3.19
2380,2012,55692,1783,2010,59485,93.62,3.00,3.38
2380,2013,55721,1821,2414,59956,92.94,3.04,4.03
2380,2014,55939,1880,2676,60495,92.47,3.11,4.42
2380,2015,56281,1882,2903,61066,92.16,3.08,4.75
2380,2016,56581,1920,3244,61745,91.64,3.11,5.25
2380,2017,56998,1997,3606,62601,91.05,3.19,5.76
2380,2018,57305,2013,3909,63227,90.63,3.18,6.18
2380,2019,57458,2067,4254,63779,90.09,3.24,6.67
2380,2020,57569,2077,4339,63985,89.97,3.25,6.78
2380,2021,57740,2159,4425,64324,89.76,3.36,6.88
2380,2022,57903,2217,4594,64714,89.48,3.43,7.10
2380,2023,57967,2272,4642,64881,89.34,3.50,7.15
2401,2010,6705,222,171,7098,94.46,3.13,2.41
2401,2011,6619,229,200,7048,93.91,3.25,2.84
2401,2012,6583,239,217,7039,93.52,3.40,3.08
2401,2013,6527,239,240,7006,93.16,3.41,3.43
2401,2014,6534,242,309,7085,92.22,3.42,4.36
2401,2015,6473,248,339,7060,91.69,3.51,4.80
2401,2016,6497,259,376,7132,91.10,3.63,5.27
2401,2017,6455,255,393,7103,90.88,3.59,5.53
2401,2018,6430,259,429,7118,90.33,3.64,6.03
2401,2019,6445,250,448,7143,90.23,3.50,6.27
2401,2020,6441,246,421,7108,90.62,3.46,5.92
2401,2021,6403,257,440,7100,90.18,3.62,6.20
2401,2022,6386,265,415,7066,90.38,3.75,5.87
2401,2023,6348,273,412,7033,90.26,3.88,5.86
2403,2010,2282,79,99,2460,92.76,3.21,4.02
2403,2011,2236,76,119,2431,91.98,3.13,4.90
2403,2012,2210,72,139,2421,91.28,2.97,5.74
2403,2013,2208,71,157,2436,90.64,2.91,6.44
2403,2014,2207,74,170,2451,90.04,3.02,6.94
2403,2015,2186,77,190,2453,89.12,3.14,7.75
2403,2016,2180,71,203,2454,88.83,2.89,8.27
2403,2017,2171,70,210,2451,88.58,2.86,8.57
2403,2018,2152,73,225,2450,87.84,2.98,9.18
2403,2019,2125,71,212,2408,88.25,2.95,8.80
2403,2020,2133,64,190,2387,89.36,2.68,7.96
2403,2021,2129,59,207,2395,88.89,2.46,8.64
2403,2022,2106,65,201,2372,88.79,2.74,8.47
2403,2023,2100,69,179,2348,89.44,2.94,7.62
2404,2010,5203,221,83,5507,94.48,4.01,1.51
2404,2011,5106,238,90,5434,93.96,4.38,1.66
2404,2012,5009,238,112,5359,93.47,4.44,2.09
2404,2013,4978,236,130,5344,93.15,4.42,2.43
2404,2014,4949,252,182,5383,91.94,4.68,3.38
2404,2015,4930,244,197,5371,91.79,4.54,3.67
2404,2016,4914,251,248,5413,90.78,4.64,4.58
2404,2017,4875,267,270,5412,90.08,4.93,4.99
2404,2018,4852,271,313,5436,89.26,4.99,5.76
2404,2019,4805,281,337,5423,88.60,5.18,6.21
2404,2020,4855,294,336,5485,88.51,5.36,6.13
2404,2021,4920,294,336,5550,88.65,5.30,6.05
2404,2022,4892,300,312,5504,88.88,5.45,5.67
2404,2023,4855,302,304,5461,88.90,5.53,5.57
2409,2010,6442,230,159,6831,94.31,3.37,2.33
2409,2011,6340,240,182,6762,93.76,3.55,2.69
2409,2012,6276,244,197,6717,93.43,3.63,2.93
2409,2013,6281,249,208,6738,93.22,3.70,3.09
2409,2014,6223,266,235,6724,92.55,3.96,3.49
2409,2015,6226,275,270,6771,91.95,4.06,3.99
2409,2016,6202,290,292,6784,91.42,4.27,4.30
2409,2017,6178,284,322,6784,91.07,4.19,4.75
2409,2018,6156,281,325,6762,91.04,4.16,4.81
2409,2019,6129,286,332,6747,90.84,4.24,4.92
2409,2020,6113,306,329,6748,90.59,4.53,4.88
2409,2021,6155,312,319,6786,90.70,4.60,4.70
2409,2022,6092,326,341,6759,90.13,4.82,5.05
2409,2023,6060,352,328,6740,89.91,5.22,4.87
2417,2010,4024,134,146,4304,93.49,3.11,3.39
2417,2011,3958,119,160,4237,93.42,2.81,3.78
2417,2012,3865,123,184,4172,92.64,2.95,4.41
2417,2013,3837,121,217,4175,91.90,2.90,5.20
2417,2014,3807,132,241,4180,91.08,3.16,5.77
2417,2015,3785,132,259,4176,90.64,3.16,6.20
2417,2016,3727,131,267,4125,90.35,3.18,6.47
2417,2017,3674,147,265,4086,89.92,3.60,6.49
2417,2018,3677,157,260,4094,89.81,3.83,6.35
2417,2019,3589,153,244,3986,90.04,3.84,6.12
2417,2020,3562,168,215,3945,90.29,4.26,5.45
2417,2021,3570,187,214,3971,89.90,4.71,5.39
2417,2022,3540,195,212,3947,89.69,4.94,5.37
2417,2023,3499,218,207,3924,89.17,5.56,5.28
2418,2010,3094,79,101,3274,94.50,2.41,3.08
2418,2011,3044,91,95,3230,94.24,2.82,2.94
2418,2012,3010,94,92,3196,94.18,2.94,2.88
2418,2013,2961,94,100,3155,93.85,2.98,3.17
2418,2014,2897,90,128,3115,93.00,2.89,4.11
2418,2015,2865,90,154,3109,92.15,2.89,4.95
2418,2016,2852,88,160,3100,92.00,2.84,5.16
2418,2017,2830,106,197,3133,90.33,3.38,6.29
2418,2018,2787,117,218,3122,89.27,3.75,6.98
2418,2019,2725,117,226,3068,88.82,3.81,7.37
2418,2020,2687,119,218,3024,88.86,3.94,7.21
2418,2021,2675,138,221,3034,88.17,4.55,7.28
2418,2022,2645,165,223,3033,87.21,5.44,7.35
2418,2023,2586,183,221,2990,86.49,6.12,7.39
2421,2010,5852,178,90,6120,95.62,2.91,1.47
2421,2011,5753,173,100,6026,95.47,2.87,1.66
2421,2012,5692,185,129,6006,94.77,3.08,2.15
2421,2013,5606,189,159,5954,94.16,3.17,2.67
2421,2014,5576,193,186,5955,93.64,3.24,3.12
2421,2015,5529,205,209,5943,93.03,3.45,3.52
2421,2016,5451,208,240,5899,92.41,3.53,4.07
2421,2017,5397,206,299,5902,91.44,3.49,5.07
2421,2018,5366,199,347,5912,90.76,3.37,5.87
2421,2019,5310,208,334,5852,90.74,3.55,5.71
2421,2020,5260,217,349,5826,90.28,3.72,5.99
2421,2021,5260,224,324,5808,90.56,3.86,5.58
2421,2022,5201,234,312,5747,90.50,4.07,5.43
2421,2023,5089,240,292,5621,90.54,4.27,5.19
2422,2010,2466,139,131,2736,90.13,5.08,4.79
2422,2011,2410,143,176,2729,88.31,5.24,6.45
2422,2012,2349,143,181,2673,87.88,5.35,6.77
2422,2013,2323,142,130,2595,89.52,5.47,5.01
2422,2014,2269,137,159,2565,88.46,5.34,6.20
2422,2015,2224,140,152,2516,88.39,5.56,6.04
2422,2016,2216,141,178,2535,87.42,5.56,7.02
2422,2017,2207,146,163,2516,87.72,5.80,6.48
2422,2018,2218,153,151,2522,87.95,6.07,5.99
2422,2019,2193,161,135,2489,88.11,6.47,5.42
2422,2020,2165,158,119,2442,88.66,6.47,4.87
2422,2021,2165,177,118,2460,88.01,7.20,4.80
2422,2022,2124,195,117,2436,87.19,8.00,4.80
2422,2023,2068,215,104,2387,86.64,9.01,4.36
2425,2010,2683,71,124,2878,93.22,2.47,4.31
2425,2011,2643,79,140,2862,92.35,2.76,4.89
2425,2012,2593,79,122,2794,92.81,2.83,4.37
2425,2013,2559,82,116,2757,92.82,2.97,4.21
2425,2014,2536,82,139,2757,91.98,2.97,5.04
2425,2015,2491,77,172,2740,90.91,2.81,6.28
2425,2016,2469,72,178,2719,90.81,2.65,6.55
2425,2017,2409,71,166,2646,91.04,2.68,6.27
2425,2018,2368,65,135,2568,92.21,2.53,5.26
2425,2019,2359,63,129,2551,92.47,2.47,5.06
2425,2020,2315,70,113,2498,92.67,2.80,4.52
2425,2021,2271,74,114,2459,92.35,3.01,4.64
2425,2022,2224,82,107,2413,92.17,3.40,4.43
2425,2023,2163,94,82,2339,92.48,4.02,3.51
2460,2010,7994,183,237,8414,95.01,2.17,2.82
2460,2011,8029,195,241,8465,94.85,2.30,2.85
2460,2012,8042,208,272,8522,94.37,2.44,3.19
2460,2013,8057,230,296,8583,93.87,2.68,3.45
2460,2014,8055,218,343,8616,93.49,2.53,3.98
2460,2015,8000,218,375,8593,93.10,2.54,4.36
2460,2016,8040,219,436,8695,92.47,2.52,5.01
2460,2017,8067,222,487,8776,91.92,2.53,5.55
2460,2018,8048,226,511,8785,91.61,2.57,5.82
2460,2019,8120,237,515,8872,91.52,2.67,5.80
2460,2020,8191,252,554,8997,91.04,2.80,6.16
2460,2021,8242,270,542,9054,91.03,2.98,5.99
2460,2022,8167,258,538,8963,91.12,2.88,6.00
2460,2023,8249,271,539,9059,91.06,2.99,5.95
2462,2010,6746,159,230,7135,94.55,2.23,3.22
2462,2011,6645,165,238,7048,94.28,2.34,3.38
2462,2012,6510,162,269,6941,93.79,2.33,3.88
2462,2013,6429,160,298,6887,93.35,2.32,4.33
2462,2014,6333,170,345,6848,92.48,2.48,5.04
2462,2015,6287,176,366,6829,92.06,2.58,5.36
2462,2016,6244,173,388,6805,91.76,2.54,5.70
2462,2017,6197,182,408,6787,91.31,2.68,6.01
2462,2018,6184,189,379,6752,91.59,2.80,5.61
2462,2019,6116,186,366,6668,91.72,2.79,5.49
2462,2020,6025,175,339,6539,92.14,2.68,5.18
2462,2021,5965,166,354,6485,91.98,2.56,5.46
2462,2022,5872,163,358,6393,91.85,2.55,5.60
2462,2023,5746,175,342,6263,91.75,2.79,5.46
2463,2010,2820,141,78,3039,92.79,4.64,2.57
2463,2011,2785,139,83,3007,92.62,4.62,2.76
2463,2012,2694,163,101,2958,91.08,5.51,3.41
2463,2013,2609,161,105,2875,90.75,5.60,3.65
2463,2014,2558,163,117,2838,90.13,5.74,4.12
2463,2015,2512,177,143,2832,88.70,6.25,5.05
2463,2016,2499,196,180,2875,86.92,6.82,6.26
2463,2017,2473,193,143,2809,88.04,6.87,5.09
2463,2018,2469,214,136,2819,87.58,7.59,4.82
2463,2019,2445,216,133,2794,87.51,7.73,4.76
2463,2020,2437,236,132,2805,86.88,8.41,4.71
2463,2021,2444,228,135,2807,87.07,8.12,4.81
2463,2022,2435,234,113,2782,87.53,8.41,4.06
2463,2023,2365,243,110,2718,87.01,8.94,4.05
2480,2010,104262,4587,6624,115473,90.29,3.97,5.74
2480,2011,105036,4661,6768,116465,90.19,4.00,5.81
2480,2012,105763,4738,6793,117294,90.17,4.04,5.79
2480,2013,106417,4902,7030,118349,89.92,4.14,5.94
2480,2014,107255,5098,7260,119613,89.67,4.26,6.07
2480,2015,108262,5240,7275,120777,89.64,4.34,6.02
2480,2016,109449,5448,7995,122892,89.06,4.43,6.51
2480,2017,110469,5616,8995,125080,88.32,4.49,7.19
2480,2018,111665,5784,9670,127119,87.84,4.55,7.61
2480,2019,112634,5865,10402,128901,87.38,4.55,8.07
2480,2020,113591,5879,10754,130224,87.23,4.51,8.26
2480,2021,114091,5904,11002,130997,87.09,4.51,8.40
2480,2022,114780,6072,11383,132235,86.80,4.59,8.61
2480,2023,115333,6245,11513,133091,86.66,4.69,8.65
2481,2010,11566,326,484,12376,93.46,2.63,3.91
2481,2011,11497,321,525,12343,93.15,2.60,4.25
2481,2012,11454,327,570,12351,92.74,2.65,4.62
2481,2013,11334,321,615,12270,92.37,2.62,5.01
2481,2014,11210,337,661,12208,91.83,2.76,5.41
2481,2015,11122,348,707,12177,91.34,2.86,5.81
2481,2016,11062,356,769,12187,90.77,2.92,6.31
2481,2017,11030,360,867,12257,89.99,2.94,7.07
2481,2018,10925,396,907,12228,89.34,3.24,7.42
2481,2019,10914,399,932,12245,89.13,3.26,7.61
2481,2020,10971,409,944,12324,89.02,3.32,7.66
2481,2021,10912,406,946,12264,88.98,3.31,7.71
2481,2022,10867,421,955,12243,88.76,3.44,7.80
2481,2023,10856,411,946,12213,88.89,3.37,7.75
2482,2010,67547,1643,2451,71641,94.29,2.29,3.42
2482,2011,67302,1638,2640,71580,94.02,2.29,3.69
2482,2012,67245,1684,2845,71774,93.69,2.35,3.96
2482,2013,67170,1670,3148,71988,93.31,2.32,4.37
2482,2014,66909,1692,3423,72024,92.90,2.35,4.75
2482,2015,66696,1740,3595,72031,92.59,2.42,4.99
2482,2016,66568,1787,3911,72266,92.12,2.47,5.41
2482,2017,66597,1850,4276,72723,91.58,2.54,5.88
2482,2018,66240,1892,4335,72467,91.41,2.61,5.98
2482,2019,66242,1946,4401,72589,91.26,2.68,6.06
2482,2020,66346,1988,4506,72840,91.08,2.73,6.19
2482,2021,66376,2207,4810,73393,90.44,3.01,6.55
2482,2022,66423,2663,5316,74402,89.28,3.58,7.14
2482,2023,66433,3338,6771,76542,86.79,4.36,8.85
2505,2010,6171,197,161,6529,94.52,3.02,2.47
2505,2011,6103,212,179,6494,93.98,3.26,2.76
2505,2012,6054,223,190,6467,93.61,3.45,2.94
2505,2013,6018,226,227,6471,93.00,3.49,3.51
2505,2014,5983,231,270,6484,92.27,3.56,4.16
2505,2015,5943,241,287,6471,91.84,3.72,4.44
2505,2016,5885,252,305,6442,91.35,3.91,4.73
2505,2017,5840,241,359,6440,90.68,3.74,5.57
2505,2018,5751,249,334,6334,90.80,3.93,5.27
2505,2019,5652,246,322,6220,90.87,3.95,5.18
2505,2020,5603,255,287,6145,91.18,4.15,4.67
2505,2021,5573,275,295,6143,90.72,4.48,4.80
2505,2022,5520,309,282,6111,90.33,5.06,4.61
2505,2023,5511,331,271,6113,90.15,5.41,4.43
2506,2010,2894,172,95,3161,91.55,5.44,3.01
2506,2011,2837,179,98,3114,91.10,5.75,3.15
2506,2012,2779,171,104,3054,91.00,5.60,3.41
2506,2013,2701,165,114,2980,90.64,5.54,3.83
2506,2014,2617,162,128,2907,90.02,5.57,4.40
2506,2015,2587,166,134,2887,89.61,5.75,4.64
2506,2016,2564,164,148,2876,89.15,5.70,5.15
2506,2017,2522,168,131,2821,89.40,5.96,4.64
2506,2018,2491,175,128,2794,89.16,6.26,4.58
2506,2019,2477,175,133,2785,88.94,6.28,4.78
2506,2020,2440,180,98,2718,89.77,6.62,3.61
2506,2021,2424,183,100,2707,89.55,6.76,3.69
2506,2022,2374,188,105,2667,89.01,7.05,3.94
2506,2023,2328,187,94,2609,89.23,7.17,3.60
2510,2010,4761,236,173,5170,92.09,4.56,3.35
2510,2011,4710,252,157,5119,92.01,4.92,3.07
2510,2012,4643,264,179,5086,91.29,5.19,3.52
2510,2013,4614,246,206,5066,91.08,4.86,4.07
2510,2014,4575,249,262,5086,89.95,4.90,5.15
2510,2015,4503,257,312,5072,88.78,5.07,6.15
2510,2016,4434,265,406,5105,86.86,5.19,7.95
2510,2017,4409,274,398,5081,86.77,5.39,7.83
2510,2018,4372,292,337,5001,87.42,5.84,6.74
2510,2019,4303,306,314,4923,87.41,6.22,6.38
2510,2020,4244,300,307,4851,87.49,6.18,6.33
2510,2021,4176,313,291,4780,87.36,6.55,6.09
2510,2022,4139,336,285,4760,86.95,7.06,5.99
2510,2023,4129,329,270,4728,87.33,6.96,5.71
2513,2010,3338,126,147,3611,92.44,3.49,4.07
2513,2011,3279,119,151,3549,92.39,3.35,4.25
2513,2012,3207,125,165,3497,91.71,3.57,4.72
2513,2013,3134,124,178,3436,91.21,3.61,5.18
2513,2014,3087,119,203,3409,90.55,3.49,5.95
2513,2015,3036,126,233,3395,89.43,3.71,6.86
2513,2016,3022,132,224,3378,89.46,3.91,6.63
2513,2017,2969,133,265,3367,88.18,3.95,7.87
2513,2018,2931,137,234,3302,88.76,4.15,7.09
2513,2019,2906,147,262,3315,87.66,4.43,7.90
2513,2020,2871,146,272,3289,87.29,4.44,8.27
2513,2021,2836,154,262,3252,87.21,4.74,8.06
2513,2022,2740,183,237,3160,86.71,5.79,7.50
2513,2023,2700,219,243,3162,85.39,6.93,7.69
2514,2010,15211,1225,304,16740,90.87,7.32,1.82
2514,2011,15058,1206,327,16591,90.76,7.27,1.97
2514,2012,14965,1188,365,16518,90.60,7.19,2.21
2514,2013,14821,1176,390,16387,90.44,7.18,2.38
2514,2014,14719,1158,430,16307,90.26,7.10,2.64
2514,2015,14646,1137,465,16248,90.14,7.00,2.86
2514,2016,14538,1135,550,16223,89.61,7.00,3.39
2514,2017,14419,1116,634,16169,89.18,6.90,3.92
2514,2018,14330,1090,638,16058,89.24,6.79,3.97
2514,2019,14139,1077,670,15886,89.00,6.78,4.22
2514,2020,14044,1095,673,15812,88.82,6.93,4.26
2514,2021,13980,1079,709,15768,88.66,6.84,4.50
2514,2022,13904,1086,739,15729,88.40,6.90,4.70
2514,2023,13719,1107,721,15547,88.24,7.12,4.64
2518,2010,3651,1020,141,4812,75.87,21.20,2.93
2518,2011,3621,1036,153,4810,75.28,21.54,3.18
2518,2012,3587,1021,164,4772,75.17,21.40,3.44
2518,2013,3516,1007,186,4709,74.67,21.38,3.95
2518,2014,3479,1009,223,4711,73.85,21.42,4.73
2518,2015,3384,977,242,4603,73.52,21.23,5.26
2518,2016,3308,957,269,4534,72.96,21.11,5.93
2518,2017,3249,924,288,4461,72.83,20.71,6.46
2518,2018,3205,910,295,4410,72.68,20.63,6.69
2518,2019,3167,898,234,4299,73.67,20.89,5.44
2518,2020,3115,889,213,4217,73.87,21.08,5.05
2518,2021,3131,887,193,4211,74.35,21.06,4.58
2518,2022,3077,881,161,4119,74.70,21.39,3.91
2518,2023,3090,858,140,4088,75.59,20.99,3.42
2521,2010,5532,647,103,6282,88.06,10.30,1.64
2521,2011,5531,636,103,6270,88.21,10.14,1.64
2521,2012,5519,646,114,6279,87.90,10.29,1.82
2521,2013,5513,643,143,6299,87.52,10.21,2.27
2521,2014,5483,644,176,6303,86.99,10.22,2.79
2521,2015,5369,603,221,6193,86.69,9.74,3.57
2521,2016,5224,599,293,6116,85.42,9.79,4.79
2521,2017,5173,593,335,6101,84.79,9.72,5.49
2521,2018,5144,595,300,6039,85.18,9.85,4.97
2521,2019,5127,599,326,6052,84.72,9.90,5.39
2521,2020,5084,599,283,5966,85.22,10.04,4.74
2521,2021,5116,591,266,5973,85.65,9.89,4.45
2521,2022,5049,589,245,5883,85.82,10.01,4.16
2521,2023,5037,587,247,5871,85.79,10.00,4.21
2523,2010,17214,722,489,18425,93.43,3.92,2.65
2523,2011,17094,699,533,18326,93.28,3.81,2.91
2523,2012,17010,728,569,18307,92.92,3.98,3.11
2523,2013,16971,727,641,18339,92.54,3.96,3.50
2523,2014,16858,743,630,18231,92.47,4.08,3.46
2523,2015,16691,765,667,18123,92.10,4.22,3.68
2523,2016,16448,786,722,17956,91.60,4.38,4.02
2523,2017,16253,769,803,17825,91.18,4.31,4.50
2523,2018,16012,744,874,17630,90.82,4.22,4.96
2523,2019,15868,760,901,17529,90.52,4.34,5.14
2523,2020,15757,749,956,17462,90.24,4.29,5.47
2523,2021,15685,731,1033,17449,89.89,4.19,5.92
2523,2022,15579,755,1086,17420,89.43,4.33,6.23
2523,2023,15417,793,1120,17330,88.96,4.58,6.46
2560,2010,7833,263,239,8335,93.98,3.16,2.87
2560,2011,7704,274,275,8253,93.35,3.32,3.33
2560,2012,7630,295,275,8200,93.05,3.60,3.35
2560,2013,7573,297,298,8168,92.72,3.64,3.65
2560,2014,7528,315,328,8171,92.13,3.86,4.01
2560,2015,7504,323,356,8183,91.70,3.95,4.35
2560,2016,7445,331,417,8193,90.87,4.04,5.09
2560,2017,7395,360,519,8274,89.38,4.35,6.27
2560,2018,7324,351,465,8140,89.98,4.31,5.71
2560,2019,7273,349,444,8066,90.17,4.33,5.50
2560,2020,7241,359,454,8054,89.91,4.46,5.64
2560,2021,7202,362,445,8009,89.92,4.52,5.56
2560,2022,7094,379,438,7911,89.67,4.79,5.54
2560,2023,6976,392,415,7783,89.63,5.04,5.33
2580,2010,67611,3463,3104,74178,91.15,4.67,4.18
2580,2011,67846,3433,3147,74426,91.16,4.61,4.23
2580,2012,68094,3489,3322,74905,90.91,4.66,4.43
2580,2013,68450,3497,3436,75383,90.80,4.64,4.56
2580,2014,68778,3502,3686,75966,90.54,4.61,4.85
2580,2015,68795,3563,3730,76088,90.42,4.68,4.90
2580,2016,69063,3640,4067,76770,89.96,4.74,5.30
2580,2017,69216,3714,4540,77470,89.35,4.79,5.86
2580,2018,69217,3755,4860,77832,88.93,4.82,6.24
2580,2019,69132,3807,5166,78105,88.51,4.87,6.61
2580,2020,69368,3841,5340,78549,88.31,4.89,6.80
2580,2021,69411,3896,5560,78867,88.01,4.94,7.05
2580,2022,69462,3970,5812,79244,87.66,5.01,7.33
2580,2023,69475,3946,5931,79352,87.55,4.97,7.47
2581,2010,39111,1046,735,40892,95.64,2.56,1.80
2581,2011,39108,1035,799,40942,95.52,2.53,1.95
2581,2012,39186,1049,843,41078,95.39,2.55,2.05
2581,2013,39309,1045,924,41278,95.23,2.53,2.24
2581,2014,39455,1062,991,41508,95.05,2.56,2.39
2581,2015,39402,1082,1064,41548,94.83,2.60,2.56
2581,2016,39409,1100,1395,41904,94.05,2.63,3.33
2581,2017,39405,1123,1656,42184,93.41,2.66,3.93
2581,2018,39361,1132,1623,42116,93.46,2.69,3.85
2581,2019,39434,1137,1710,42281,93.27,2.69,4.04
2581,2020,39314,1121,1791,42226,93.10,2.65,4.24
2581,2021,39370,1139,1814,42323,93.02,2.69,4.29
2581,2022,39341,1157,1864,42362,92.87,2.73,4.40
2581,2023,39276,1186,1882,42344,92.75,2.80,4.44
2582,2010,25768,937,766,27471,93.80,3.41,2.79
2582,2011,25776,947,920,27643,93.25,3.43,3.33
2582,2012,25559,956,1083,27598,92.61,3.46,3.92
2582,2013,25530,1013,1295,27838,91.71,3.64,4.65
2582,2014,25519,1035,1333,27887,91.51,3.71,4.78
2582,2015,25493,1047,1373,27913,91.33,3.75,4.92
2582,2016,25514,1053,1475,28042,90.98,3.76,5.26
2582,2017,25433,1051,1697,28181,90.25,3.73,6.02
2582,2018,25369,1086,1609,28064,90.40,3.87,5.73
2582,2019,25310,1118,1652,28080,90.14,3.98,5.88
2582,2020,25267,1110,1683,28060,90.05,3.96,6.00
2582,2021,25299,1119,1742,28160,89.84,3.97,6.19
2582,2022,25143,1136,1769,28048,89.64,4.05,6.31
2582,2023,24967,1169,1807,27943,89.35,4.18,6.47
2583,2010,6061,3847,151,10059,60.25,38.24,1.50
2583,2011,6040,3814,187,10041,60.15,37.98,1.86
2583,2012,5961,3732,211,9904,60.19,37.68,2.13
2583,2013,5928,3711,247,9886,59.96,37.54,2.50
2583,2014,5850,3665,261,9776,59.84,37.49,2.67
2583,2015,5859,3634,338,9831,59.60,36.96,3.44
2583,2016,5816,3599,449,9864,58.96,36.49,4.55
2583,2017,5751,3512,542,9805,58.65,35.82,5.53
2583,2018,5717,3513,555,9785,58.43,35.90,5.67
2583,2019,5698,3440,547,9685,58.83,35.52,5.65
2583,2020,5686,3404,511,9601,59.22,35.45,5.32
2583,2021,5644,3349,503,9496,59.44,35.27,5.30
2583,2022,5540,3281,519,9340,59.31,35.13,5.56
2583,2023,5460,3224,493,9177,59.50,35.13,5.37
2584,2010,20917,1487,540,22944,91.17,6.48,2.35
2584,2011,20900,1471,596,22967,91.00,6.40,2.60
2584,2012,20852,1464,656,22972,90.77,6.37,2.86
2584,2013,20934,1495,767,23196,90.25,6.45,3.31
2584,2014,20914,1508,819,23241,89.99,6.49,3.52
2584,2015,20799,1487,892,23178,89.74,6.42,3.85
2584,2016,20619,1488,1060,23167,89.00,6.42,4.58
2584,2017,20463,1483,1170,23116,88.52,6.42,5.06
2584,2018,20287,1491,1214,22992,88.24,6.48,5.28
2584,2019,20118,1489,1260,22867,87.98,6.51,5.51
2584,2020,19835,1526,1303,22664,87.52,6.73,5.75
2584,2021,19639,1553,1363,22555,87.07,6.89,6.04
2584,2022,19387,1667,1369,22423,86.46,7.43,6.11
2584,2023,19253,1751,1429,22433,85.82,7.81,6.37
